Artist: VA
Album: Midnight Club LA
Year: 2008
Tracks: 97
Quality: 320 kbps
Size: 765 Mb

Tracklist:
Eclectic:
Tricky - Baligaga
Sensi All Stars Vs Ctrl-Z - Big Riddim
Shodan & Offkey - Boogie Down
Markus Kienzl - Dundy Lion
Slim Blue Feat. Ken Mac Vs Polkadot - Flick It
Danny Byrd - Red Mist
Hyper - Replica
Plump DJs - Snake Eyes
Qemists - Stompbox
Deadmau5 - The Oshawa Connection
Equalizers - Wide Awake

Electronic:
Kid Cudi - 'Day 'N' Lite'(Crookers Remix)
Digitalism - Idealistic
Presents - Kicking And Screaming
SantoGold - L.E.S. Artistes(Switch Remix)
Kudu - Lets Finish(Sinden Remix)
South Rakkas Crew - Mad Again (Boy 8 Bit Remix) Feat New Kids
Chemical Brothers - Midnight Madness
SebastiAn - Momy
Wolf Gartner - Montezuma
Holy F*** - Royal Gregory
Evil Nine Feat Beans - Set It Off
Wolf Gartner - Squares
Diplo Feat Rye Rye - Wassup(Crookers Remix)
Matt Herdman - Wasted Intellect
K.I.M. - Wet & Wild

Hard Rock:
NIN - 1000000
Shinedown - Cry For Help
NIN - Discipline
Fever - Eyes On The Road
The Vines - Get Out
33 HZ - I Feel Alive (Ming Mix)
Disturbed - Indestructible
Subways - Kalifornia
Agent Elf - Lost In Control
Feeder - Miss You
As I Lay Dying - Nothing Left
We Are Wolves - Psychic Kids
Evil Nine Feat. Emily Breeze - Twist The Knife
Darker My Love - Waves

Hip-Hop:
Reks - All In One
Evil Nine Feat Aesop Rock - Crooked
Kids On The Hall Feat Masta Ace - Driving Down The Block(Low End Theory)
Tech N9ne - EveryBody Move
Get Coll - Go!
Maino - Hi Hater
J*Mil - Like Dat
Nas Feat Keri Hilson - Nas Hero
Young Jeezy Feat Kanye West - Put On
Nas - Sly Fox
G-Unit - Straight Outta Southside
Dope Nixon - The Wait Is Over
Coll Kids - What Is This
Gliss - Blue Sky
MGMT - Electric Feel(Juctice Remix)
Dukes Of Windsor - In The Wild
Foals - Mathletics
Bloc Party - Mercury
Black Kids - Partie Traumatic
Young Restless - Police! Police!
Tilly And Wall - Pot Kettle Black
CSS - Rat Is Dead(Rage)
Social Distortion - Reach For The Sky
NO Age - Sleeper Hold
Primal Scream - Suicide Bomb
Wolf & Cub - Targets(Minotaur Shock Remix)
Beck - Time Bomb
Whip - Trash
Eagles Of Death Metal - Wannabe In LA

Techno:
Franz & Shape - Acceleration
Alex Gopher - Belmondo (The Subs Alexcalibur Remix
Antiform - Boombox (Screwface)
Alex Gopher - Dust
Dataworx - Focus
Kid Dub - Future Shock(John Acquaviva)
John Acquaviva & Oliver Giacomotto - Good (Dopamine Rmx)
Alex Dolby - Smokin Mountain
John Acquaviva & Oliver Giacomotto - Sofa King (Fresco Remix)
Modeselektor - The Black Block
Modeselektor - The White Fresh Feat. Thom Yorke (Trentemoller Remix)
John Acquaviva & Olivier Giacomotto - Too Cool 4 Skoo (Jonny Lexxs Remix)l
Olivier Giacomotto - Wasabi On Top
Kavinsky - Wayfarer(Original Remix)

West Coast Rap:
Randam Luck - ''1,2 Hit Em''
*The Games* - Big Dreames
Bishop Lamont Feat. The New Royals - City Lights
Ozomat Li - City Of Angels
Ice Cube - Gangsta Rap Made Me Do It
Dj Felli Fel Feat. Diddy,Akon,Ludacris,Lil Jon - Get Buck In Here
Too $hort Feat Snoop Dogg & Will.l.Am - Kepp Bouncin
Evidence - Let Yourself Go
Murs Feat. Will.l.Am - Looking Fly
Akwid - No Hay Manera(Jason Roberts Remix)
Snoop Dogg Feat. Kurupt - Press Play
Busy Feat. Murs - To Protect And Entertain
Wc - West Coast Rap
Young MayLay - You Ain't Uh


Seed When Downloaded!!!:)