 http://enigmat.webhop.net
.
Become a Fan of My Facebook Page --  by clicking LIKE -- for latest updates
.
.
Aitor Ronda - Bolaian Buyaka (Reaky Remix) (Cut From Ronald Set)-enTc.mp3
Armin van Buuren Feat. System F - From the Heart (Mr. DSC Funk 2010 Mix) (Cut From Hunt Set)-enTc.mp3
Aurum Beats - Green Line (Original Mix) (Cut From Anderson Set)-enTc.mp3
Bjorn Akesson - Sandcastle Express (Original Mix) (Cut From A&F Set)-enTc.mp3
Bobo - Courage (Blank & Jones Remix) (Cut From B&J Set)-enTc.mp3
Darren Tate & Jono Grant - Let The Light Shine In (Corderoy Remix) (Cut From A&F Set)-enTc.mp3
Dart Rayne - Caravan (Cut From Imagin Set)-enTc.mp3
Dave Emanuel - Four Noble Truths (Mike Danis Remix) (Cut From Eco Set)-enTc.mp3
Decibel Monkeys feat. Marcie - Primordial Clouds (Original Mix) (Cut From Anderson Set)-enTc.mp3
Dereck Recay - Nebula (Eco Remix) (Cut From Eco Set)-enTc.mp3
Des McMahon - Rain Maker (-Short- Cut From Askew Set) (Â«â€¢Â»)-enTc.mp3
DJ Eco - War (Original Mix) (Cut From Kaeno Set)-enTc.mp3
DJ Urry Fefelove & Abramasi - Autobahn (Cut From Kaeno Set) (Â«â€¢Â»)-enTc.mp3
Fernie pres. Moonshot  Religion (Science Deal Remix) (Cut From Fernie Set)-enTc.mp3
Halifax - Reveal Your Innocence (Fandy Remix) (Cut From Airbase Set)-enTc.mp3
homas DeColita Feat. Suzy Solar - The Unsaid (Manuel Juveras Dedicated For A.O. Mix) (Cut From Suzy Set)-enTc.mp3
John Askew - Nailgun (Greg Downey Remix) (-Sample-)-enTc.mp3
Kai Jee N Eidan - Go And See My Love (Karl G Remix) (Cut From A&F Set)-enTc.mp3
lank & Jones - Menue (Intro) (Cut From B&J Set) (Â«â€¢Â»)-enTc.mp3
Lisko - Dead Voices (TrancEye Remix) (Cut From Space Garden Set)-enTc.mp3
Marco V and Ali Wilson - Kaos Theory (Cut From Myon Set)-enTc.mp3
Matt Skyer - Chumpavision (Mike Wind Remix) (-Sample- From Askew Set)-enTc.mp3
Matt Skyer - Throwing Sword (Cut From Patterson Set)-enTc.mp3
Paul Miller - TDI (Cut From Ronald Set)-enTc.mp3
Planet Perfecto - Bullet In The Gun (Chris B & Paul Byrne 2010 Remix) (Cut From Jong Set)-enTc.mp3
Proyal - Dreamland (Ernest Miller Remix) (Cut From Tasev Set)-enTc.mp3
Ronald de Foe - Old Times (Cut From Askew Set)-enTc.mp3
Samuel Jason - Morning Sun (MLV Remix) (Cut From Airbase Set)-enTc.mp3
Sandeagle - Summer Clue (Light Sequence Remix) (Cut From Anderson Set)-enTc.mp3
SHato - Final Exam (A.T.M. Remix) (Cut From Space Garden Set)-enTc.mp3
Sky Motion - Sweet Dreams (Original Mix) (Cut From A&F Set)-enTc.mp3
Solex - The Beginning Of The End (Cut From Airbase Set)-enTc.mp3
SoundLift - Live From Above (Arctic Moon Remix) (Cut From Fast Dist Set)-enTc.mp3
Stephen Coyle - Abort (Original Mix) (Cut From Trainer Set)-enTc.mp3
Talla 2XLC vs Robert Burian - Pro Life (Akira Kayosa Remix) (Cut From Suzy Set)-enTc.mp3
Tucandeo - Layla (DJ Eco Remix) (Cut From Airbase Set)-enTc.mp3
Victor Dinaire & Bissen Featuring Peter Finley - Tonight You Are Perfect (Original Mix) (Cut From Dinaire Set)-enTc.mp3
