Various Artist - Punk Goes Classic Rock (2010)
Mp3
CBR 320
Front Cover


1. More Than A Feeling (Boston Cover)	Hit The Lights 	
2. Paint It Black (The Rolling Stones Cover)	Versaemerge 	
3. Free Fallin' (Tom Petty Cover) 	Almost 	
4. We Are The Champions (Queen Cover)	Mayday Parade 	
5. Rock 'N' Roll All Nite (Kiss Cover)	Summer Set 	
6. Caught Up In You (.38 Special Cover)	We The Kings 	
7. Separate Ways(Worlds Apart) (Journey Cover)	Skylit Drive 	
8. Your Love (Outfield Cover)	I See Stars 	
9. (Don't Fear)The Reaper (Blue Oyster Cult Cover) Pierce The Veil 	
10.Crazy Train (Ozzy Osbourne Cover)	Forever The Sickest Kids 	
11.Pour Some Sugar On Me (Def Leppard Cover) The Maine 	
12.All Along The Watchtower (Jimi Hendrix Cover) Envy On The Coast 	
13.Take Me Home Tonight (Eddie Money Cover) 	Every Avenue 	
14.Bohemian Rhapsody (Queen cover) 	Never Shout Never 	
15.Dream On (Aerosmith Cover) 	blessthefall


Enjoy!