SF283 

Get Shaky - Ian Carey Project 
Supernova - Mr Hudson Feat. Kanye West 
22 - Lily Allen 
Where Did All The Love Go - Kasabian 
Chillin' - Wale Feat. Lady Gaga 
Birthday Sex -Jeremih 
Let's Get Outta Here - Madina Lake 
Fire Burning - Sean Kingston 
Get Sexy - Sugababes 
Holiday - Dizzee Rascal 
Outta Here - Esmee Denters 
Uprising - Muse 
Sexy Bitch - David Guetta Feat. Akon 
Boys And Girls - Pixie Lott 
Ready For The Weekend - Calvin Harris 
Behind Closed Doors - Peter Andre 

SMW915 
Red Rain - Peter Gabriel 
Wood Beez - Scritti Politti 
Whatever I Do (Wherever I Go) - Hazell Dean 
Quicksand - La Roux 
Trigger Hippie - Morcheeba 
Movin' On Up - Primal Scream 
Matthew & Son - Cat Stevens 
In Between Days - The Cure 
Lollipop - The Chordettes 
Into Your Arms - The Lemonheads 
My Sister - Juliana Hatfield 
Embraceable You - Frank Sinatra 
Signed, Sealed, Delivered I'm Yours - Stevie Wonder 
The Galway Girl - Mundy 
I'm Not Crying - Flight Of The Conchords
