 http://enigmat.webhop.net
.
.
Alex Kidd - Unholy Grail (Cut From Schossow Set) (Â«â€¢Â»)-enTc.mp3
Anhken - Green Line (Ronski Speed Remix) (Cut From Anhken Set)-enTc.mp3
Arnej vs. 8 Wonders - Beggining Of The End (ASOT 438 Rip)-enTc.mp3
Calvin Harris - Flashback (Ben Nicky Remix) (Cut From Jules Set)-enTc.mp3
Dan Stone - Fahrenheit (Adam Nickey Remix) (ASOT 438 Rip)-enTc.mp3
Deadmau5 & Chris Lake - I Said (Michael Woods Remix) (Set Rip)-enTc.mp3
DJ Ruby - Off The Hook (Original Mix) (Cut From Ronde Set)-enTc.mp3
DK Project - Blue Skies (SoundLift Remix) (Set Rip)-enTc.mp3
Element One - International Language (Original Mix) (Cut From Ronde Set)-enTc.mp3
Exalted - Tsunami (Cut From Navy Blue Set)-enTc.mp3
Hiroyuki ODA - Thirty (Cut From Kenji Set)-enTc.mp3
Ivan Mateluna Feat. Tiff Lacey - Be My Inspiration (SoundLift Remix) (Set Rip)-enTc.mp3
Jean Michelle Jarre - Equinoxe Part 4 (Ferry Tayle Remix) (Cut From Navy Blue Set)-enTc.mp3
John O'Callaghan - Striker (Ummet Ozcan Remix) (ASOT 438 Rip)-enTc.mp3
KIWAMU - Birth (Cut From Kenji Set)-enTc.mp3
Kyohei Akagawa - Innersole (Cut From Kenji Set)-enTc.mp3
Lost Witness - Closer To Love (Cut From Jules Set)-enTc.mp3
Luiz Toniolo - Second Thoughts (Cut From Ronde Set)-enTc.mp3
Mark Sinclair - Pictures Of You (Terry Ferminal Remix) (ASOT 438 Rip)-enTc.mp3
Mike Davis - Harsh Dawn (Original Booty Mix) (Cut From Ronde Set)-enTc.mp3
Predictionz - My Summerz (Approaching Black Remix) (Cut From Ronde Set)-enTc.mp3
Rage Against The Machine - Killing In The Name (Deadmau5 Edit) (Set Rip)-enTc.mp3
Rank 1 vs. Jochen Miller - The Great Escape (ASOT 438 Rip)-enTc.mp3
Robert Gitelman - Fluidum (ASOT 438 Rip)-enTc.mp3
Roses & Garlics - The Last Birds (Cut From Ilgaz Set) (Â«â€¢Â»)-enTc.mp3
SoundLift - Against The Wind (Original Emotional Mix) (Set Rip)-enTc.mp3
SoundLift - Boavista (Original Mix) (Set Rip)-enTc.mp3
SoundLift - UNTITLED -Sept 2009- (Set Rip)-enTc.mp3
Stimulator - Cry For You (Paul Morrell Remix) (Cut From Jules Set) (Â«â€¢Â»)-enTc.mp3
Stoneface & Terminal - Don't Give A Fuck (ASOT 438 Rip)-enTc.mp3
The Prodigy - Omen (Dean Newton Remix) (Cut From Schossow Set) (Â«â€¢Â»)-enTc.mp3
Thomas Sagstad - Crinkle (Cut From Schossow Set) (Â«â€¢Â»)-enTc.mp3
Timmy & Tommy & Bryan Kearney - Loco Motive (Cut From Schossow Set)-enTc.mp3
Tom Green & Kevin Cadd - Darklight (Original Mix) (Cut From Ronde Set)-enTc.mp3
Ummet Ozcan - Next Phase (Phase One Mix) (ASOT 438 Rip)-enTc.mp3
UNKNOWN - UNTITLED (Anhken Remix) (Cut From Anhken Set)-enTc.mp3
Van Dressler - Promises (Original Mix) (Cut From Ilgaz Set)-enTc.mp3
Will Atkinson - 3746 (Cut From Jules Set)-enTc.mp3
Will Atkinson & Hilton - Timeless Thoughts (Cut From Jules Set)-enTc   {320}.mp3
