Plataforma: X360
NÂº de Jugadores: 1
Online: SÃ­
GÃ©nero:MÃºsica
Desarrollado por:Neversoft
Distribuido por:Activision Blizzard
Video:R.Free
Idiomas:Multi5 Spanish

Resumen:
Aires nuevos, guitarra nueva
Como ya es norma habitual en Guitar Hero, esta nueva entrega vendrÃ¡ acompaÃ±ada del correspondiente rediseÃ±o de su perifÃ©rico estrella, la guitarra. Esta presenta un diseÃ±o mÃ¡s â€œagresivoâ€, por decirlo de algÃºn modo, y su peso se verÃ¡ incrementado ligeramente en relaciÃ³n a los modelos previos. TambiÃ©n, el frontal de la misma serÃ¡ intercambiable, pudiendo adquirir nuevos modelos para personalizarla. Y en cuanto a sus prestaciones, en las versiones para PS3 y Xbox 360 destaca la implementaciÃ³n de los botones del pad en el mÃ¡stil de la misma, mientras que en la de Wii serÃ¡ posible integrar el Wiimote en esa misma zona. Â¡Ah! Y ya podÃ©is decir adiÃ³s al controvertido â€œslide padâ€, que desaparecerÃ¡ por completo.

El resto de funciones y demÃ¡s caracterÃ­sticas de Warriors of Rock sÃ­ que permanecerÃ¡n inalterables con respecto a ediciones previas, y eso incluirÃ¡ al apartado tÃ©cnico, que no presentarÃ¡ novedades relevantes.

Por lo visto, Activision quiere revitalizar su franquicia musical estrella con esta nueva ediciÃ³n, llevÃ¡ndola al terreno del rock caÃ±ero y â€œundergroundâ€ que tan buenos resultados les dio en los comienzos.

Tracklist:
Aerosmith - Cryin'
AFI - Dancing Through Sunday
Alice Cooper - No More Mr. Nice Guy
Alter Bridge - Ties That Bind
Anberlin - The Feel Good Drag
Anthrax - Indians
Arch Enemy - Nemesis
Atreyu - Ravenous
Avenged Sevenfold - Bat Country
Bad Brains - Re-Ignition (Live)
Band Of Skulls - I Know What I Am
Black Sabbath - Children of the Grave
Blind Melon - Tones Of Home
Blue Ã–yster Cult - Burnin' For You
Bush - Machinehead
Buzzcocks - What Do I Get?
Children of Bodom - If You Want Peaceâ€¦ Prepare for War
Creedence Clearwater Revival - Fortunate Son
The Cure - Fascination Street
Deep Purple - Burn
Def Leppard - Pour Some Sugar On Me (Live)
Dethklok - Bloodlines
The Dillinger Escape Plan - Setting Fire To Sleeping Giants
Dire Straits - Money For Nothing
DragonForce - Fury of the Storm
Drowning Pool - Bodies
The Edgar Winter Group - Free Ride
Fall Out Boy - Dance, Dance
Five Finger Death Punch - Hard To See
Flyleaf - Again
Foo Fighters - No Way Back
Foreigner - Feels Like The First Time
George Thorogood and the Destroyers - Move It On Over (Live)
Interpol - Slow Hands
The Hives - Tick Tick Boom
Jane's Addiction - Been Caught Stealing
Jethro Tull - Aqualung
John 5 - Black Widow of La Porte
Kiss - Love Gun
Linkin Park - Bleed It Out
Lynyrd Skynyrd - Call Me The Breeze (Live)
Megadeth - Sudden Death, Holy Wars... The Punishment Due, This Day We Fight!
Metallica & Ozzy Osbourne - Paranoid (Live)
Muse - Uprising
My Chemical Romance - Iâ€™m Not Okay (I Promise)
Neil Young - Rockin' In The Free World
Nickelback - How You Remind Me
Night Ranger - (You Can Still) Rock in America
Nine Inch Nails - Wish
The Offspring - Self Esteem
Orianthi - Suffocated
Pantera - I'm Broken
A Perfect Circle - The Outsider
Phoenix - Lasso
Poison - Unskinny Bop
Queen - Bohemian Rhapsody
QueensrÃ¿che - Jet City Woman
Rammstein - Waidmanns Heil
Ramones - Theme From Spider-Man
R.E.M. - Losing My Religion
Red Rider - Lunatic Fringe
The Rolling Stones - Stray Cat Blues
Rise Against - Savior
The Runaways - Cherry Bomb
Rush - 2112 Pt. 1 (Overture)
Rush - 2112 Pt. 2 (The Temples of Syrinx)
Rush - 2112 Pt. 3 (Discovery)
Rush - 2112 Pt. 4 (Presentation)
Rush - 2112 Pt. 5 (Oracle: The Dream)
Rush - 2112 Pt. 6 (Soliloquy)
Rush - 2112 Pt. 7 (Grand Finale)
RX Bandits - It's Only Another Parsecâ€¦
Silversun Pickups - Thereâ€™s No Secrets This Year
Slash Feat. Ian Astbury & Izzy Stradlin - Ghost
Slayer - Chemical Warfare
Slipknot - Psychosocial
Snot - Deadfall
Soundgarden - Black Rain
Steve Vai - Speeding
Stone Temple Pilots - Interstate Love Song
Strung Out - Calling
Styx - Renegade
Sum 41 - Motivation
Tesla - Modern Day Cowboy
Them Crooked Vultures - Scumbag Blues
Third Eye Blind - Graduate
Tom Petty & The Heartbreakers - Listen To Her Heart
Twisted Sister - Weâ€™re Not Gonna Take It
The Vines - Get Free
The White Stripes - Seven Nation Army
ZZ Top - Sharp Dressed Man (Live)