DJ King Pigeon: a sad, middle-aged recluse living alone in a seedy motel. His mission: world peace. His method: celebrating Europe\\\'s myriad music scenes through dj\\\'ing.


Royksopp - The Girl and the Robot
Mange Schmidt - Ledig
Fuzzy Hair - Let\\\'s Work It (Yebele)
Roger Sanchez feat. Terri B - Bang That Box (Laidback Luke Remix)
Get Far - The Radio (Get Far and Paolo Sandrini Extended Mix)
DJ Ella - Shine Like a Superstar
Deadmau5 (feat Rob Swire) - Ghosts
Residence Deejays and Frissco - Sexy Love
Ani Christy - Klor Mor
Fboti - Piano Player (Original Club Mix)
Deck Jagger - Gay Clubs Are Better
Cash & Bloom - Three Ladies
Agnieszka Chylinska - Nie Moge Cie Zapomniec
Violina - Sellel Ã¶Ã¶l (feat. Lenna Kuurmaa)
Super Mal - Dow Dow (Original Mix)
Bad Boy Bill - Do What U Like (Bad Boy Bill\\\'s Push That Feeling Remix)
Jean Claude Ades, Lenny Fontana & Tyra - Nite Time (Radio Edit)
CJ Stone - Shining Star (Martin Roth Dub Remix)
Shark & Sylvain - Call Me
Saxsymbol (feat. Lex Empress ) - Samba de Liberdade (Ricky Rivaro\\\'s Sundale Mix)
Camilla Brinck - KK (Alex Sayz Extended Remix)
Lazard - Your Heart Keeps Beating (Stefano Sorrentino Mix)
Atmos - Twin Reaction
Pixie Lott - Boys and Girls (Ralph Rosario Remix)
Angie B - Soundwaves
Shemian - 1927
Sonq Nemska - Horoskop
Caater - O Si Nene
Gloriq - Opiat
Eon - The Spice
Demet Akalin - Mucize
Kosheen - Catch
The Sounds - No One Sleeps When I\\\'m Awake
Niki - Tea et minna nyyd vid
Thomas Bronzwaer - Look Ahead
Goodnight to all my friends in Slovenia