TOP-60

            Top music for decade
            Various Artists-(MIXED BY I.B)

            50 CENT NEYO - BABY BY ME.mp3
            Ace of Base - All That She Wants.mp3
            Apollo 440 - Ain Talking bout Dub.mp3
            All The Things She Said-t.A.T.u.mp3
            Roger Sanchez - Another Chance.mp3
            Babylon Zoo - Spaceman.mp3
            Michael Jackson - Beat It.mp3
            U2 - Beautiful Day.mp3
            Flunk - Blue Monday.mp3
            Limp Bizkit-Boiler.mp3
            Bosson - One in a Million (From Miss Congeniality Soundtrack).mp3
            Britney Spears - I Was Born To Make You Happy.mp3
            McLean Ft. Tinchy Stryder - Broken (Remix).mp3
            C-Block - So strong out.mp3
            Guns N Roses - Estranged.mp3
            Billy Idol - Eyes without a face.mp3
            Kelly Family - Fell In Love With An Alien.mp3
            Fragma - Tocas Miracle.mp3
            watergate - heart of asia.mp3
            Dido - Here With Me.mp3
            Haddaway - I Miss You.mp3
            Coldplay - In My Place.mp3
            Sonique - It Feels So Good.mp3
            Jennifer Lopez - JLo - 18 - Waiting For Tonight.mp3
            Bang Bang (My Baby Shot Me Down)By Nancy Sinatra.mp3
            Fugees - Killing me softly.mp3
            Bob Dylan - Knocking On Heavens Door.mp3
            Madonna - Madona - La isla bonita.mp3
            Kaoma - Lambada.mp3
            Lapdance (Paul Oakenfold Swordfish Mix).mp3
            KLF - Last Train to Trancentral.mp3
            Freddie Mercury - Living On My Own.mp3
            George Zamfir - The Lonely Shepherd (Kill Bill Soundtrack)(1).mp3
            Enrique Iglesias - Love To See You Cry.mp3
            Martika - Toy Soldiers.mp3
            Melanie C - I Turn To You (Techno Remix).mp3
            Modjo - Lady (Hear Me Tonight).mp3
            Robert Miles Feat. Maria Nayler - One & One.mp3
            Energy 52 - Cafe Del Mar.mp3
            Massive Attack - Unfinished Sympathy (Oakenfold Remix).mp3
            Prodigy - Breathe.mp3
            Paul Oakenfold - Ready Steady Go.mp3
            The Real Thing.mp3
            Rebekah Del Rio - Llorando (Crying) Mulholland Drive Soundtrack.mp3
            PPK-Resurection (radio mix).mp3
            Tony Montana-Scarface Soundtrack-Tony Theme Opening Title (Movie).mp3
            Flunk - Six-Seven Times.mp3
            Akon Feat. Eminem - Smack That (Dirty).mp3
            Sonique - Fly So High (Touch The Sky).mp3
            Paul Oakenfold - Southern Sun (Original Mix).mp3
            Shakespears Sister - Stay.mp3
            Tanita Tikaram - Twist In My Sobriety(1).mp3
            Tasmin Archer - Sleeping Satellite.mp3
            Massive Attack -Teardrop.mp3
            Titanic Soundtrack - Rose Theme (Solo Piano Version).mp3
            U2 - Ultraviolet (Light My Way).mp3
            Dj sammy - were in heaven (techno remix).mp3
            4 Non Blondes - What's Up.mp3
            Charles and Eddie - Would I Lie to You Baby.mp3
            Vanessa Williams & Chayanne - You Are My Home.mp3