Arsenik och gamla spetsar (1944)

De tvÃ¥ fÃ¶rtjusande gamla systrarna Abby och Martha Brewster, bor i ett gammalt hus 

i Brooklyn, dÃ¤r de idkar olika former av vÃ¤lgÃ¶renhet. I denna svarta fars hjÃ¤lper 

de Ã¤ldre fattiga ensamma mÃ¤n till en lyckligare tillvaro genom att fÃ¶rgifta dem 

med sitt flÃ¤derbÃ¤rsvin, spetsat med arsenik...


Originaltitel
Arsenic and Old Laces

Land, Ã¥r, lÃ¤ngd
USA Ã¥r 1944, 118 min

RegissÃ¶r
Frank Capra

Manus
Julius J. Epstein
Philip G. Epstein

SkÃ¥despelare
Cary Grant - Mortimer Brewster
Josephine Hull - Abby Brewster
Jean Adair - Martha Brewster
Priscilla Lane - Elaine Harper
Raymond Massey - Jonathan Brewster
John Alexander - "Teddy Roosevelt" Brewster
Peter Lorre - Dr. Einstein
James Gleason - Lt. Rooney
Jack Carson - O'Hara
Edward Everett Horton - Mr. Witherspoon
Grant Mitchell - Reverend Harper
Edward McNamara - Brophy
Garry Owen - Taxi Driver
John Ridgely - Saunders
Vaughan Glaser - Judge Cullman
Chester Clute - Dr. Gilchrist
Charles Lane - Reporter
Edward McWade - Gibbs
Leo White - Man in Phone Booth
Spencer Charters - Marriage License Clerk
Hank Mann - Photographer
Lee Phelps - Umpire

Produktions info

Sol Polito - FOTO

Joseph Kesselring - FÃ¶rfattare

Daniel Mandell - Klippning

Max Steiner - Musik

Leo F. Forbstein - Musik

Hugo Friedhofer - Musik

