ARTiST.....: VA
TiTLE......: Magic Mix Vol.19 Bootleg
YEAR.......: 2009
GENRE......: Dance
QUALiTY....: VBRkbps / 44.1kHz / Joint-Stereo
BiTRATE....: avg. 190kbps
TRACKS.....: 01
SiZE.......: 109,2 MB
PLAYTiME...: 79:58 Min

TRACKSLiST:

[01] VA - Intro                                                                    [     ]
[02] VA - Magic Dance                                                              [     ]
[03] VA - House Arrest                                                             [     ]
[04] VA - Downtownmix                                                              [     ]

Magic Dance

Opening
50 Seconds Sampling Action with DJ Magic
Topless - Love Story
Royal Artists - When Love Takes Over
The Real Booty Babes - Booty Clap
Cascada - Fever
Alex Megane - Stars
Discotronic - I Surrender
The Black Eyed Peas - I Gotta Feeling
DJ Squared - Its My Life
Prime Time - Right Roung
Jumpboys - Jumpen oder so
The Vamprockerz - Vamos A La Playa
Nivara - No One Can Stop us
Boomtown - I Love NY
Ultra DJs - Alone
Manox - Almost Lover
Ultrabeat - Starry Eyed Girl
Plasco - Stay
Darius and Finlay - Destination
Rob and Chris - Superheld
Rocco - Everybody 9.0
Culture Beat - Mr. Vain Recall
Annakiya - Vergessen
Pulsedriver - Peace

House Arrest

Opening
Sanders and Deenasty - Sway 2k9
Mark oh - United
Michael Mind - Gotta Let you Go
Darren Baile - Protect Your Mind 2009
Conways feat. Dominoe - Here I Am 2009
David Guetta feat. Akon - Sexy Bitch
Katy Perry - waking up in Vegas
Flat Eric meets DJ Cruse - Flat Beat 2009
Horny UNited - L.O.I.
Klaas meets Haddaway - What is Love 2009
Tanzpeitsche - Und das heisst
Sharam feat. Kid Cudi - She Came Along
The Disco Boys feat. Midge Ure - The Voice
DJ Ross vs. Double You - Pease Dont Go
DJ OGB feat. Francisco and Gemeni - Hands Up
Booty Luv - Say It
Madonna - Celebration

Downtownmix

Opening
DJ Size - Time of my Life
Lady Gaga - Paparazzi
Colbie Calaiat - Fallin for You
Emiliana Torrini - Jungle Drum
Lenka - The Show
James MOrrison - Nothing Ever Hurt Like You
Lolene - Sexy People
Ne Yo - Dont Worry About It
Shakira - She Wolf
Sugababes - Get Sexy
Backstreet Boys - Straight Through my Heart
Nelly Furtado - Manos Al Aire
Pitbull - Hotel Room Service
Lily Allen - Fuck You
Hannah Schneider - Waiting for your