Death Sentence (2007)

Nick Hume Ã¤r en vÃ¤luppfostrad man med ett perfekt liv - tills en vidrig natt nÃ¤r 

han bevittnar nÃ¥got som fÃ¶rÃ¤ndrar hans liv fÃ¶r evigt. FÃ¶rÃ¤ndrad av sorg kommer 

Hume sÃ¥ smÃ¥ningom fram till att han inte kan gÃ¥ fÃ¶r lÃ¥ngt nÃ¤r det gÃ¤ller att 

skydda sin familj.



Originaltitel
Death Sentence

USA Ã¥r 2007, 105 min

RegissÃ¶r

James Wan

Manus
Ian Jeffers

SkÃ¥despelare
Kevin Bacon - Nicholas "Nick" Hume
Kelly Preston - Helen Hume
John Goodman - Bones Darly
Garrett Hedlund - Billy Darly
Aisha Tyler - Detective Wallis
Matt O'Leary - Joe Darly
Logga in fÃ¶r att se fler skÃ¥despelare
Leigh Whannell - Spink
Yorgo Constantine - Michael Behring
Stuart Lafferty - Brendan Hume
Edi Gathegi - Bodie
Jordan Garrett - Lucas Hume
Zachary Dylan Smith - Young Brendan Hume
Hector Atreyu Ruiz - Heco
Elizabeth Keener - Amy
Kanin J. Howell - Baggy
Mark Jeffrey Miller - Funeral Parlor Clerk
Coby Jennings - Henning
David Michie - Dawg
Desiree Markella - Bus Girl
Rich Ceraulo - Owen
Bruce Williamson - Homeless man
Juan-Carlos Guzman - Sammy
Casey Pieretti - Dog
Jay Amor - Dock Rat
Jim Keisler - Courtroom Observer
Aqeel Hasan - ER Doctor
Freddy Bouciegues - Tommy
Susan Crosby - Business Woman
Bob Harter - Mr. Perle

Produktions info

Jennifer L. Smith - CASTING

Mary Tricia Wood - CASTING

John R. Leonetti - FOTO

Brian Garfield - FÃ¶rfattare

Michael N. Knue - Klippning

Kristin M. Burke - Kostym