The new siteis now up and running. Changing to LeakCity.com soon.
As we said before, we won't keep doing torrents for long, just trying to get some traffic
to the site first. Go tofor daily leak/singles, new music videos,
mixtapes, and covers of a couple mixtapes yet to be released so you know what to be on the
lookout for

Also, visit the site to download Lil Wayne's new mixtape "No Ceilings"!!!!!

October 26-28th New Singles - enjoy!

50 Cent - Psycho (Feat. Eminem)
Amerie - More Than Love (Feat. Fabolous)
B.o.B - I Feed These Streets
Bobby Creekwater - Steady Mobbin' (Remix)
Brisco - Thinking To Myself (Feat. Lil Wayne & Birdman)
Chief Stockton - Missin' You (Feat. T-Pain)
DJ Khaled - Fed Up (Feat. Usher, Young Jeezy, Rick Ross & Drake)
Glasses Malone - Til' Death Do Us Part (Feat. Xzibit)
Gorilla Zoe - Alright (Patron)
Gucci Mane - Burrr (Remix) (Feat. Ya Boy)
Horse Shoe Gang - You Don't Wanna Fuck Wit Me (Feat. Crooked I)
J. Holiday - Back
Joell Ortiz - Run This Town Freestyle
Lil Wayne - Banned From TV
Lil Wayne, T-Streets, Shanell & Mack Maine - Let's Go Crazy
Lupe Fiasco - All The Way Turnt Up Freestyle
Mary J. Blige - I Can See In Color
Missy Elliott - Put It On Ya (Feat. Teyana Taylor)
Ne-Yo - When He Kissed Me
R. Kelly - Echo
Ryan Leslie - Sunday Night
Shawnna - Believe Me (Feat. John Legend)
Shwayze - Livin' It Up (Feat. Snoop Dogg)
Snoop Dogg - Empire State Of Mind (Remix) (Feat. Alicia Keys)
Sonny Rich - Rick James (Feat. E-40)
Soulja Boy - I Can Make These Hoes Dance
Soulja Boy - PlayBall (Feat. Drake)
Tyga - Party Girl (Feat. Lloyd)
Wale - Letter (Feat. John Mayer)
Willy Northpole - Battery Acid
Z-Ro - Haters Got Me Wrong (Feat. Gucci Mane & Chris Ward)