Mash Up With Annie Mac
Groove Armada, Crazy Cousinz
2009-07-17


Er7Radio.net & Scanner771


Tracks


21:00
Ducksauce- 'ANYway' (Fools Gold)
Unknown - 'Playing With Chives'
Greg Wilson - 'Ruff  Wrap' (White)
The Requesters - 'Warriors' (Moda Music)
The Streets - 'In The Middle (Nero Remix)' (White)
MJ Cole ft Serocee - 'AO Annie VIP' (Prolific Records)
Major Laser - 'Can't Stop Now' (Downtown Music)
P-Money - 'Everything (Blame Remix)' (White)

Vintage Mini Mix by Groove Armada

Crazy Cousinz - 'Bongo Drums' (White)
Juan Maclean - 'Happy House' (DFA)
NNEKA - 'Heartbeat (Chase & Status Remix)' (Yomama's Records)

Mash Hits: Toddla T with Cascada - 'Evacuate The Dancefloor'
 
Siriusmo - 'Gummiband' (White)
Johnny L - 'Dreaming (Utah Jaxx Remix)' (White)
Bloc Party - 'One More Chance
(Alex Metric Remix)' (Wichita)
MSTRKRFT - 'Heartbreaker (Laidback Luke Remix)' (Geffen)
Zinc - 'Watch Dis' (White)
Kid Sister - 'Right Hand Hi' (White)
Basement Jaxx ft Sam Sparro - 'Feelings Gone'
Hercules And Love Affair - 'Blind' (DFA)
Riton & Primary 1 - 'Who's There (Doorly Remix)' (Fantasy)
Crystal Clear & AMP - 'Itzalot (Annie VIP)

Crazy Cousinz Mini Mix
Crazy Cousinz Ft MC Versatile - 'Funky Anthem'
Boy Better Know - 'Too Many Man'
Donaeo - 'Party Hard'
Gracious K - 'Migraine Skank'
Fuzzy Logic Ft Egypt - 'In The Morning'
Steve Angelo - 'Show Me Love (Geeneus Remix)'
Benga N Coki - 'Night'
Eremiah - 'Birthday Sex'
Envyi & K.P - 'Swing My Way'
Calvin Harris - 'I'm Not Alone'
Hardsoul - 'Self Religion'
Sia - 'Little Man'
P2J & Fre3 - 'Tribal Skank'
Karizma - 'Darqness'
Enur Ft Natasja - 'Calabria 2007'
Black Eyed Peas - 'Boom Boom Pow'
Meleka - 'Go (Crazi Cousinz Remix)'
Wiley - 'Wearing My Rolex'
Dizzee Rascal - 'Bonkers'
Lethal B Ft Donaeo - 'Go Hard'
Crazy Cousinz & Kyla - 'Do You Mind'
Yonurican - 'Boriken Soul (Dub Mix)'
Lil Silva - 'Different'
Kig - 'H.S.K.T'
Hard House Banton - 'Sirens'
David Guetta Ft Kelly Rowland6 - 'When Love Takes Over'
D Malice - 'Gabrieyle Apple'
Chants Crazy Cousinz Ft Calista - 'Bongo Jam'


Disco Dance Off
Nuyorican Soul - 'Runaway' (Mercury)
Patrice Rushden - 'Forget Me Nots' (Electra)
Database - 'Beaches and Friends (Twelves Remix)'
Ducksauce - 'The Motion' (Fools Gold)
Michael Jackson - 'Pretty Young Thing' (Epic)
Donna Summer - 'Dim All The Lights' (Casablanca Records)
Buckethead - The Bomb (These Sounds Fall Into My Mind)' (Positivia)
Voodoo Chilli - 'Get On Down' (White)

---------------------------------------------
Home
        
http://Er7Radio.net/