Fireproof (2008)

PÃ¥ jobbet, inne i brinnande hus, lever kapten Caleb Holt efter den gamla devisen: 

LÃ¤mna aldrig en kollega efter dig. Hemma och i sitt Ã¤ktenskap lever han efter sina 

egna regler. Efter sju Ã¥rs Ã¤ktenskap har Caleb och Catherine Holt vÃ¤xt isÃ¤r sÃ¥ 

till den milda grad att Catherine Ã¶nskar att de aldrig gift sig.


Originaltitel
Fireproof

Land, Ã¥r, lÃ¤ngd
USA Ã¥r 2008, 122 min

RegissÃ¶r
Alex Kendrick

Manus
Alex Kendrick
Stephen Kendrick

SkÃ¥despelare
Kirk Cameron - Caleb Holt
Erin Bethea - Catherine Holt
Alex Kendrick - Pastor Strauss
Bailey Cave - Ross Spencer
Jason McLeod - Eric Harmon
Jim McBride - Carl Hatcher
Janet Lee Dapper - ER Nurse
Tommy McBride - Kyle Joiner
Ray Wood - Mr. Campbell
Walter Burnett - Dr. Anderson
Harris Malcom - John Holt
Allison Dawson - Mrs. Turner
Stephen Dervan - Wayne Floyd
Kelly Johnson - Bethany Wilson
Eric Young - Terrell Sanders
Blake Bailey - Stephanie Mills
Amberly Marquard - Ashley Phillips
Ken Bevel - Michael Simmons
Phyllis Malcom - Cheryl Holt
Deena Taylor - Misty Harper
Anthony Brown - James Turner
Bill Stafford - Mr. Rudolph
Sue Holt - Mrs. Campbell
Perry Revell - Gavin Keller
Dwan Williams - Deidra Harris
Stephanie Makulinski - Robin Cates
Renata Williams - Latasha Brown
Melanie Tomlinson - Kelsey Jackson
Taylor Glow - Megan
Carla Hawkins - Tina Simmons
Faye Sharber - Anna Stone
Heidi Johnson - Dispatcher
Dot Majors - Erma Rudolph

Produktions info

Bob Scott - FOTO

Bill Ebel - Klippning

Rob Whitehurst - Ljud

Mark Willard - Musik

Stephen Kendrick - Producent

Alex Kendrick - Producent
