Bon Jovi - You Give Love A Bad Name (Tony Pryde Remix)
50 Cent - P.I.M.P (South & Adoo Radio Edit)
Atb - You Are Not Alone (Extended Version Evo Remix DJ LIGA)
Big Ali - Number One (Swedish House Mafia Cover)
Blue Affair & Sasha Dith Feat Carlprit - Ya Odna (Greysound Remix)
Brooklyn Bounce - Bass, Beats & Melody Reloaded! (Disco Freak Remix)
Cabella Feat. Daisy - My Heart Goes Boom (Godlike Music Port Remix)
Club Revolution - Go !!!  (Original Mix)
Cool Project - MYaSO MUSIC ver 8.0(Dj LeD RemiX)
Coolio - Gangstas Paradise (Rico Bernasconi & Max Farenthide Remix)
Dada Life - Cookies With A Smile (Remakerz Remix)
Dani B. Vs. Karim R. - Be Together (Dani B. & Dark Angel Remix)
David Guetta ft Tiesto - In On
Delia Matache - The beach is on fire (Miami beach 2010)
Disco Sound - Techtonic (Gread Beat radio edit)
Disco Superstars - Slice Me Nice (OceansBasse rmx)
Discotronic meets Tevin - To The Moon And Back (M. Deejay & Tunebot Remix)
Discotronic vs.Tevin - To The Moon and Back (Mark Pride Radio Edit 2010)
DJ Antoine - Starting Tonight (Steve Murano Radio Edit)
DJ Jeroenski,Bjorn B - Electro Blue (Deekly Club Mix)
DJ Optick, Avi, DJ Andi, Serban Cazan, Chris Mayer  Connect-R - Free Your Mind 2010 (Imnul Liberty Parade)
DJ Smash - Ptitca (Radio Edit)
DJ's DaOzlshinoda - Apologize ( Sweet Dream Electro Cover )
DK and TJC - Maybe You Can Get My Beat (The Mobb Remix Edit)
Dr Alban vs Sash! - Hello South Africa (Rico Bernasconi & Max Farenthide Mix)
Feeldi & Daan'D - Mamy Blue 2010 ( System & Berry Cake Rmx )
Fely feat. Puya - Vreau sa te sun
Finger and Kadel - So Sehn Sieger Aus (Scha la la) (Bigroom Mix)
Geo Da Silva vs Dj Magnum - Cine Bea Cu Noi bootleg Horny
Greg Parys - Why Don't We Just Fuck (Extended Mix)
Inna - Moon Girl (Jay Amato Elektro Mix)
Inna vs David Guetta - Hot Memories (TopFloorDjs Summer Edit Mash)
Inusa Dawuda & DJ Chick - We Want More (Greysound Remix)
iTone ft Craig Smart - Im Aleady There (ClubDJTeam Remix)
Jay Ko - High Note (Radio 21 Edit)
K-Tronic & Meyson - Infinity 2k10 (Original Version)
K-Tronic & Meyson - Infinity 2k10 (Summer Club Version)
Mark Pride - Prince of Persia (Original Mix)
Max Furtado & e'Attis - Message From My Heart (Original Mix)
Menyo - Follow Your Heart (Klaas Remix)
Moreno feat. Alan Basski - Celebration (Dj Cargo Radio Remix)
Radio Killer - Voila ( DJ Nejtrino DJ Baur Killer Cut)
Reel 2 Real (Feat Sean Paul, Pitbull, Flo Rida & T Pain) - I Like To Move It (Electro Urban Remix)
Rock City - Live As One (Feat. Akon)
Ryan S. - Breakaway (Original Mix)
Sean Kingston - Eenie Meenie (DJ Skarsvogue Electro Edit)
Sean Kingston - Fire Burning (Cherry Coke Remix)
Sir Colin Feat. Patrick Miller - Have Mercy (Fuzzy Remix)
Stuff  Floor - Up To The Beat (Gordon Doyle Ft. Players 69 Remix)
Stuff & Floor - Up To The Beat (Mondo Remix)
T-Buck - Angele Sarge
Will Smith - Gettin' Jiggy Wit It (DJ Nejtrino & DJ Baur Jiggy Edit)