TRACKLIST

The Sudden Passion - Herpes Of The Heart
Bars of Gold - Boss Level
Young Mammals - 8 4 8
The Weird Weeds - I Ain\'t Got No Family
Boston Spaceships - The British And The French
The Smiles - Cala Cola
Telekenisis - Dirty Thing
Syd Matters - Hallalcsillag
Kissed Her Little Sister - Miracle Mile
Seapony - With You
La Patere Rose - DÃ©capote (Version country beach)
Philip Sleway - Beyond Reaso
nLiving Rooms - Cave In
Dag For Dag - I Am The Assassin
The Winks - Bookface
Edwyn Collins - Losing Sleep
The Naked And The Famous - Punching In A Dream
The Jim Jones Review - Elementa
lLaetitia Sadier - One Million Year Trip
Mean Wind - Gleam Leaf Green
Summer Camp - Round The Moon
Camilo Diaz Pino - Scott Pilgrim 16bit
Heavy Hawaii - Teen Angel
Backwords - Center Of The Earth
Belle & Sebastian - Write About Love
Grinderman - Worm Tamer
Hot Panda - Evil nature
Harrys Gym - Old Man
The Hundred In The Hands - Young Aren\'t Young
Simian Ghost - Sequenced Dreams Of Independence
Broadcast & The Focus Group - Inside Out
Royksopp - Forsaken cowboy
Elf Power - The Taking Under
Museum Of Belles Artes - Who Do You Love
Britta Persson - If You Don\'t Love Him
Maximum Balloon - Tiger (Feat. Ak Orraca-Tetteh)
Sakert! - Fredrik
Babe Terror - Summertime Our League
Owen Pallett - A Man With No Ankles
Flying Lotus - Physics For Everyone
Mark Ronson & The Business International - Bang Bang Bang (Feat. Q-Tip & MNDR)
Swimmingpoo1 - Riverside Childern
Let\'s Wrestle - Crushing Nerves
Emiliana Torrini - Easy (In The Rain Acoustic)
White Denim - Home Together
British Sea Power - Zeus
Sunset - Heavy Light
Kazumasa Hashimoto - Daylight Hallucination
TV Girl - On Land
Dumbo Gets Mad - Eclectic Prawn
Big Surr - Gone
Breathe Owl Breathe - House of Gold
Honey Radar - Graying Groves High School
Amiina - In The Sun
Dark Dark Dark - In Your Dreams