*** BROUGHT 2 YOU BY DJLEAK.COM ***

08 02 09 Hip Hop N RnB Singles DJLeak com
=========================================


HIP-HOP
=======

Ace Hood - On My Grind-DJLeak.com
Alfamega - Round One-DJLeak.com
Bluey Robinson - I Know (Prod By Ryan Leslie)-DJLeak.com
Bow Wow - I'm Going In (Remix)(feat. Dj Jus)-DJLeak.com
Brisco - Burnin Rubber-DJLeak.com
Jay Rock - Day One Girl (feat. Bj The Chicago Kid)-DJLeak.com
Mase - Shut The City Down-DJLeak.com
Nas - Film (Prod. C-Sick)-DJLeak.com
Sir Aah - Grudge Me (feat. Keshav, Joell Ortiz, Crooked I)-DJLeak.com
Slaughterhouse - Onslaught 2 (feat. Fatman Scoop) (Produced By Emile)-DJLeak.com
Willie The Kid - Aviation-DJLeak.com
Young Buck - We Goin Shoppin (Prod. By Crada)-DJLeak.com


RNB
===

Asia Nitollano (Former member of PCD) - Blackout (Prod. by Konvict)-DJLeak.com
Casely feat. Vein - Signal (NoShout)-DJLeak.com
Chris Newland - Dont Know Why-DJLeak.com
Chrishan - Gucci Swag-DJLeak.com
Chrishan feat. T.I. - U Had It All (Prod. by Jim Jonsin)-DJLeak.com
Dahrio Wonder - Won`t Enough (Prod. by Kadis & Sean)-DJLeak.com
Damon - Say It Ain't So (Prod. by Darkchild)-DJLeak.com
Day 26 (Demo) - One Shot (Prod. by Tha Producerz)-DJLeak.com
Dima Bilan - Changes-DJLeak.com
Dru Hill - She Wants Me (Mastered Album Version)-DJLeak.com
Eddie B - Break Up (Prod. by Jr Rotem)-DJLeak.com
Effie - Into Yellow-DJLeak.com
Fat Joe ft. Pleasure P & Rico Love - Aloha (Mastered)-DJLeak.com
Jai Wil - There's no U & I-DJLeak.com
Jermaine Dupri ft. Johnta Austin - So Successful (CDQ)-DJLeak.com
Khrys Lawson - Get a Room (feat. Lloyd)-DJLeak.com


