John Digweed Transitions on Proton Radio Guest Magda 13-11-2009
File size : 102 MB
Duration : 1.51.50
Overall bit rate : 128 kbps

Tracklist :

John Digweed

Peter Kruger - 25 West 38th Street (Promo)
Olag Poliakov - House Of The Sun (Promo)
Kleinmond - James Flavour Remix (Promo)
Seth Troxler - Panic Stop Repeat (Spectral Sound)
Tiger Stripes - Alma (getdigital)
Mendo - Everybody I Got Him (Cadenza)
Guy J - Ballroom (Bedrock)
Ribn - Cottbus (Ovum)

Magda

Ronnie Tyler - Nicer Things - Unreleased
The Seekers - Freckles - Unreleased
Andy Martin - Gecko - Unreleased
ADCL - Hear The Wall - Railyard
Madato - 3031 - Unreleased
Butane - Adaptation - Crosstownrebels
Heartthrob - Loop 101 - minus
Gaiser - mfnstmp - minus
Leo Choi - Paradox - Unreleased
Christian Burkhardt - Eye Shadow - ?
Bruno Pronsato - We Were - Philpot
Robotman - Do Da Doo - Definitive
Hobo - Dimension - Unreleased
Tim Xavier - Yellow Corvette - LTD400
Run Stop Restore - Suck My Christmas - Logistic
Clickbox - Bad Fish - Unreleased
Sin Salida â€“ DJ Poty (Louis da K Remix) - Nopreset
Madato - Nights Rumors - Unreleased