A.L.B.A. - Power Of Love (Scotty Remix)
Al Capuccino - On To You In Ibiza (Pitey Mash Up)
Alex Mourinho - I Cant Believe It (Lovesequenzer Remix)
ALX, Jazzi Jay Muzzy G - Go Crazy (Caudill Turnipseed Remix)
Andrew Spencer - Heart Of The Ocean (Titanic Theme) (Intro Extended Mix)
Andrew Spencer - Heart Of The Ocean (Titanic Theme) (Money-G Remix)

Bangbros - Highflyer (Electro Power Project Electro Remix)
Benny Benassi feat. Gary Go - Cinema
Black Eyed Peas - The Time (The Dirty Bit)
Blue Lagoon - Break My Stride (Jarret Scott Remix)
BoB feat. Hayley Williams - Airplanes (DJ Nejtrino & DJ Baur Aeromix)
Booty-B! - Baby (Feel It) (Original Mix)
Bryce Feat. Gerald G! & J-Malik - Dance (PH Electro Remix)

Christopher S.- Komodo (Original Club Mix)
Chrizz Luvly - You For Ear (Original Mix)
Crew 7 - Paniken und Wahnsinn (Crew 7 Remix)
Chris Willis - Louder (Put Your Hands Up) (Laurent Wolf Mix)

David Guetta - Love Is Gone (Dj Amor Remix)
David Guetta Feat. Rihanna - Who's That Chick (Afrojack Remix)
David Guetta Ft. Niles Mason - Touch & Go (Final Version)
D-Code - Like i Feel (Sound Maker Feat. M!cRoOz. Pump It Remix)
DeepSystem - Work (Radio edit)
Denzell & Robinson - Since U Been Gone (PH Electro Remix)
Dirty Impact vs. Royal Xtc - Tom's Dinner (PH Electro Remix Edit)
DJ Anastasio Le Prada - Jingle Bells 2011 (Original Club Mix)
DJ Antoine vs. Mad Mark - With You (Original Mix)
Dvj Electra - I Feel You (A.Makarov Remix) (Radio Edit)
David Guetta Feat. Michele Belle - Read Your Mind

Flo Rida - Club Can't Handle Me (QiDD & Kaminiak Exclusive Remix)
Floorfilla - Anthem 4 (DJ Cerla & Marvin Remix I)
Flo-Rida - Puzzle (DjGraff Ext Mix)

Groove Coverage - Poison 2010 (Stay & Play Club Mix)
Guenta K. - Tubular Bells 2011 (Extended Mix)

Housebatze - Housebatze (Original Mix)
Hoxygen - Lla Musique Parfait (Original Extended Mix)

In Vivo- Rolerkoster( DJSing Dirty Electro 2k10)
Italo Tunez - I Can Fly Tonight (Dance Rocker Extended Remix)

Jakarta - Around the Sun (Gregori Klosman Remix)
Jamelia - Superstar 2010 (BunHeaD Original Extended Mix)
Javi Mula - Sexy Ladies (Check Dance Remix)
Javi Mula - She Sexy Ladie (Martin Parker Vox Mix)
Jonatha Barbieri Dj - Together In Love (Dj Fernando Lopez Remix)

KiD Rusty - Deep Soul House Music (Radio Edit)

L. Armstrong - Go Down Moses (Rmx New Gold Collection Amareta & Zoora)
Leon Gris, Apricota - Happy Birthday B... (Misha Zam Remix)
Loona - Vamos Ala Playa (Lost DJ & Locco Freakz! Remix)
Lolita - Joli Garcon (Rob & Chris Remix Edit)

Mancini - Lose Control (OFFBeat Remix)
Max Mafia - In Your Life (Radio Edit)
MG Traxx - I Like (Money G Remix)
Michi Fasano & Felipe C. - Sicily Emotion HD (New Single 2011 )
Mike Posner - Cooler Than Me (Kriss Raize Electro Mix)
Molella feat. Alessia D'Andrea - Paradise (Wender Remix)
Movetown - Round N Round (Instant Move Edit)
Movetown - Round N Round (Radio Edit)
MoveTown - Round N Round (TAITO vs. Base Attack Remix)
Mr. Jack-O! - Euphoria (Danny Noise Remix)
MS Project feat. Ryan Paris - Dolce Vita (Original Club Mix)

Nadia Ali - Rapture 2011  (Avicii New Generation Mix)
Nations Voice - With Time (Dj Vantraxx Remix)
Nexboy - Sweet Home Chicago ( System & Berry Cake Exclusive Rmx )
Nexboy & Cover - Love Is True (Locco Freakz! Radio Edit)

Pakito - Living On Video (Dj Amor Remix)
Paramore - That's What You Get (DJ Kenny Remix)
PH Electro - Every Breath You Take (Radio Edit)
Pitbull - Shake It (Check Dance feat Kriss Remix)
Plastik Bass feat. Oliver Kobs- Es wird laut (DJ MNS vs E-MaxX Remix)
Player & Remady vs. Juvi Mula - Come Disappear On (xaDeu' Bootleg Remix)
Prezioso and Marvin - Riddle Crank (Abramo & Buba Mashup)

Ray Knox - Corcovado (Hide & Seek Remix)
Ray Knox - Corcovado (Melodypark vs. Ray Knox Rap Version Extended)
Red5 - Da Beat Goes 10 (Crazy Z Meets Ron Ravolta Remix)
Rico Bernasconi - Clip clap (Ur Handz)
Rico Bernasconi vs. Max Farenthide - Balkan Adventure (Club Mix)
Rihanna Feat. Fatman Scoop - Only Girl In The World (Vynil Squad Remix)
Royal Djs - California Dreaming

Sample Rippers - Kick The Nation (Greysound Remix)
Slayback - She Sexy (Matt Farell Bunch of Square Remix)
Stay & Play - That's Not My Name (Club Mix)
Steve H - Outta Space (PH Electro Remix)
Stream Dance Project - Fucking HALLOWEEN (Original Mix)
Styles & Breeze - You're My Angel (Miss.U Special Remix 4BK)
Sunrider - Is Cool (Club Mix)
Sahara feat. Mario Winans - Mine (Scotty Remix)
Silver - Forgiven (Greysound Remix 2011)

The Saturdays - Higher (7th Heaven edit)
Tiesto & Diplo Ft. Girlicious - C'Mon Get Hood (Extended Vocal Mix)
Tiesto vs. Diplo - C'Mon (Hyper Crush Bootleg)
Tosh Ventura - I Feel I Like To Jump Major Tosh Remix

Victoria S - One In A Million (Scotty Remix Edit)

Yves Larock - Rise Up (Jarret Scott Remix)