Disc 1
Cheryl Cole : "Fight for This Love"
Michael BublÃ© : "Haven't Met You Yet"
Black Eyed Peas - "I Gotta Feeling"
David Guetta featuring Akon : "Sexy Chick"
La Roux : "Bulletproof"
Taio Cruz : "Break Your Heart"
N-Dubz : "I Need You"
Jason Derulo : "Whatcha Say"
Jay Sean feat. Lil Wayne : "Down"
Alesha Dixon : "To Love Again"
Chipmunk feat. Dayo Olatunji : "Oopsy Daisy"
Tinchy Stryder feat. Amelle : "Never Leave You"
Little Boots : "Remedy"
Pixie Lott : "Boys And Girls"
Mini Viva : "Left My Heart In Tokyo"
Sean Kingston : "Fire Burning"
Pitbull feat. Nicole Scherzinger : "Hotel Room Service" (Remix)
Sugababes : "Get Sexy"
The Saturdays : "Forever Is Over"
Young Soul Rebels : "I Got Soul"
Agnes : "I Need You Now"
JLS : "Beat Again"

Disc 2
Lady Gaga : "Paparazzi"
BeyoncÃ© : "Sweet Dreams"
Shakira : "She Wolf"
Jay-Z feat. Rihanna & Kanye West : "Run This Town"
Mr Hudson feat. Kanye West : "Supernova"
Robbie Williams : "Bodies"
Dizzee Rascal : "Holiday"
Calvin Harris : "Ready for the Weekend"
Whitney Houston : "Million Dollar Bill" (Frankie Knuckles Radio Mix)
The Ian Carey Project : "Get Shaky"
Chase & Status : "End Credits"
The Temper Trap : "Sweet Disposition"
Muse : "Uprising"
Snow Patrol : "Just Say Yes
Florence + The Machine : "You've Got The Love"
Lily Allen : "22"
Paolo Nutini : "Pencil Full Of Lead"
MIKA : "We Are Golden"
Cobra Starship feat. Leighton Meester : "Good Girls Go Bad"
Mumford & Sons : "Little Lion Man"
Just Jack : "The Day I Died"
EsmÃ©e Denters : "Outta Here"
deadmau5 feat. Rob Swire : "Ghosts N Stuff"
