Hofo - favorites 2009


:: AnvÃƒÂ¤ndarnas favoriter 2009! ::

HÃƒÂ¤r finner du 36 heta lÃƒÂ¥tar frÃƒÂ¥n http://www.hofo.se 
AnvÃƒÂ¤ndarna har sjÃƒÂ¤lv utsett sina favoriter till det hÃƒÂ¤r packet, enjoy !


:: The users favorites 2009! ::


36 hot tracks from http://www.hofo.se
The users have selected their favorites for this pack, enjoy ! 


- Tracklist -

Akon -  Right Now (Tobbaz Remix)
Alex Rose -  Night & Fire
Antizimex - Kalle Theodor (Sailor Edition) -  
Audiogate - Hela Golvet (Amboza Feat. Noices Remix Edit) 
Baby Alice -  Pina Colada Boy (Tobbaz Bootleg Mix)
Basebrothers - Hon vill ha kul -  
Bassbrazzer - Eight Bitz (Original Mix) -  
Boozer -  Hes A Gladiator 08 ( Original Mix )
ChaseR -  Kom och se (Radio edit)
Calle-A Hot Dance Remix -  ClubExclusive ft. Gabbe - Here In Your Arms (Calle-A Hot Dance Remix)
David K -  Kom Tillbaka [Radio edit]
Digitunez - Inget kan stoppa oss nu -  
DJ Auzern - 3rd Base (CmC Rmx!!) -  
Fairchild - All Alone 4 (Extended Mp3) -  
Geo Da Silva - Do it like a truck (Bassbrazzer Remix) -  
Hawkoon -  Brand New Me (Electro Junkiez Radio Mix)
Jake O'Connor -  Holiday
Jason Derulo -  Whatcha Say (Tunebeatz Hands Up! Remix)
Kanix Cane -  Sunset (original mix)
L-Siska - Sound of Eternity (Heartattacker Short Mix) -  
Manian - Welcome to the Club (DJ V3N0M RMX) -  
Mellony -  Mellony - Dissa IPRED
Mellony -  Mellony - Whispering my Name -  
Mellony - You and Me (Andy Harding Radio Mix) -  
Niklas J - I Never Find The Sound Of Silence -  
Niklas J och Calle A - Girl Next Door! (Orginal mix) -  
Niklas J v.s David K - Min Sommardrom -  
Partyheadz -  Stop Loving You(Timlan Remix)
Pedro & Benno -  Speechless (XposEx vs Dan-J Remix)
Pirates of the Caribbean - He is a pirate (Robin Projects Remix) -  
Ram Jam - Black Betty (The Mobb Remix) -  
Robboz - Aquarius (Radio Edit) -  
Snap -  Rhytm Is A Dancer (Dj Squash Remix)
Talang-I met you -  
Volbeat - Still Counting (Sidevind Ft. Dj Izor Clean Remix) -  
Zone Breaker -  Wicked Body Moves (Sebbit Remix)