 http://enigmat.webhop.net
.
.
.
Adam Byrd - Panarama (Art Patrice Remix) (Cut From Python Set)-enTc.mp3
Adam Fielding - Lost In Silence (Estiva Remix) (Cut From Solarstone Set) (Â«â€¢Â»)-enTc.mp3
Adiva - Desired Love (Cut From Pit Set)-enTc.mp3
Agustin Aguirre - Frozen Lips (Original Mix) (Cut From Igor Set)-enTc.mp3
Alberto V & Alession Caforio - U get Know R (Cut From Python Set)-enTc.mp3
Alex & Filip - Deconstructed (Original Mix) (Cut From Cid Set)-enTc.mp3
Alexander Miguel - Ay Vol (Python Spring Remix) (Cut From Python Set)-enTc.mp3
Andrea Saenz & Milton Channels - Atlantis (Cut From Benz Set)-enTc.mp3
Andrew Cox - Thick Java (Nick Stoynoff Remix) (Cut From Solarstone Set) (Â«â€¢Â»)-enTc.mp3
Andy Day - Star Beach (Original Mix) (Cut From Deep-Z Set)-enTc.mp3
Andy Richmond - Ain't Talkin Bout Love (Brent Sadowick Remix) (Set Rip)-enTc.mp3
Anton Chernikov Pres. Crystal Verge - Invasion (Psy Progressive Remix) (Set Rip)-enTc.mp3
Apple One - They Came From The Stars (Cut From Fast Dist Set)-enTc.mp3
Arisen Flame - Sincere (Original Mix) (Cut From Saux Set)-enTc.mp3
Armand Van Helden - Funk Phenomema (Starkillers 2010 Remix) (Cut From Benz Set)-enTc.mp3
Aspin & Dipace vs. Luvstuff - You Too (Miles Dyson Remix) (Cut From PvD Set)-enTc.mp3
ASYS & The Engineer - Acid Headcracker 2010 (ID Mix) (Cut From Kamui Set)-enTc.mp3
Autodidact Feat. Laura - Az En Zenem (Original Mix) (Cut From Haazy Set)-enTc.mp3
Avenger - Music Box (Cut From Brandt Set)-enTc.mp3
Bastards Of Funk & Sonic Union - Electron (Cid Inc Remix) (Cut From Cid Set)-enTc.mp3
BjÃ¶rn Wilke & Lewie Day - Fallstudie (Cut From Morrison Set)-enTc.mp3
Blancq & Leach - Solar Flare (RedLoft & Guido Percich Remix) (Cut From Slang Set)-enTc.mp3
Bloody Beetroots vs EOTS - Without Me (Sam la More Remix) (Cut From Tiesto Set)-enTc.mp3
Blue Tente pres. North Sight - Runaway (ReOrder Bangin Mix) (Cut From Faruk Set)-enTc.mp3
Bruno Bergeron - Downrising (XGenic Remix) (Cut From Tyas Set)-enTc.mp3
Bryan Kearney & Liam Melly - The Other Half (Thr3shold Remix) (Cut From Tyas Set)-enTc.mp3
Bushwacka - Show of Hands (Cut From Giust Set)-enTc.mp3
Cassino & Laben - Come Back To Mar Del Plata (Schodt Remix) (Cut From Slang Set) (Â«â€¢Â»)-enTc.mp3
Chip & Dale - My First Lovin (Arjuna Schiks Remix) (-96kbs- Cut From Piet Set)-enTc.mp3
Chris Chambers - Groove Osijek (Brent Sadowick Remix) (Set Rip)-enTc.mp3
Chris Metcalfe - Outback (Cut From Tyas Set)-enTc.mp3
Chris Micali - Blended (Cut From Benz Set)-enTc.mp3
Chris Mozio - My Life (Faskil Afterdark Remix) (Cut From Ferreyra Set) (Â«â€¢Â»)-enTc.mp3
Christian Cambas Feat. The Static Age - Sirens (Draft Remix) (Cut From PvD Set)-enTc.mp3
Claude Vonstroke - Vocal Chords (Original Mix) (Cut From Benz Set)-enTc.mp3
C-Systems - Don't Turn Around (Original Dub Mix) (Set Rip)-enTc.mp3
D Ramirez Feat. Ldv - The Road Of Excess (Ramirez Chant Remix) (Set Rip)-enTc.mp3
Dan Meyer - Via Maris (Cut From Flash Bro Set)-enTc.mp3
Dave Shtorn - Fluxor (Original Mix) (Cut From Solarstone Set) (Â«â€¢Â»)-enTc.mp3
Deadmau5 - Bot (Jason Mill Rework) (Cut From Stenberg Set)-enTc.mp3
Deadmau5 - Faxing Berlin (Tyler Michaud & Manuel De La Mare Remix) (Cut From Tiesto Set)-enTc.mp3
Deep Fog - Crows (Cut From Rivic Set)-enTc.mp3
Deep Fog - Rainy Days (Cut From Rivic Set)-enTc.mp3
Dennis White - Development (Chloe Harris & Andrew Cox Remix) (Cut From Igor Set)-enTc.mp3
Derek Howell - Outrageous Contageous (Ben Coda Remix) (Cut From Deep-Z Set)-enTc.mp3
Diego Mongelos - Ugly Butterfly (Cut From Bozman Set)-enTc.mp3
Dieler - Bewolkten Tag (Original Mix) (Cut From Ferreyra Set)-enTc.mp3
Digital Freq - Disco Falls (Cut From PvD Set)-enTc.mp3
DJ Choose - Sea Saw (Fredins Trouse Remix) (Cut From Flash Bro Set)-enTc.mp3
DJ FTC - Amstramata (DJ 2Frey Remix) (Set Rip) (Â«â€¢Â»)-enTc.mp3
Don Diablo - I Am Not From France (Linus Loves Remix) (Cut From Benz Set)-enTc.mp3
Edu pres. Time Traveler - Save The Planet (Danilo Ercole Remix) (Cut From Joop Set)-enTc.mp3
ee2 - Squared Up (Kornel and Peat Noise Remix) (Cut From Python Set)-enTc.mp3
Electric Traveller - Enlight (Cut From Lemon Set) (Â«â€¢Â»)-enTc.mp3
Emou - Yours (RPO Remix) (Cut From Bozman Set)-enTc.mp3
Ercossa & Twistigen - The Solstice (Matt Skyer Tech Mix) (Cut From Anderson Set)-enTc.mp3
Eric Sneo - Sugar Baby (Cut From Sherry Set)-enTc.mp3
Ericsson Feat. Jude Eliott - Dark Angel (MaRLo Remix) (Set Rip)-enTc.mp3
Eryo & Kay-D - Meridian (LoQuai BreakBeat Remix) (Cut From Rivic Set)-enTc.mp3
EverLight - Imperium (Taylor & Close full On Remix) (Cut From Divini Set)-enTc.mp3
Ex-plosion Feat. Tiff Lacey - Intimacy (Gabriel Robella Remix) (Cut From Anderson Set)-enTc.mp3
Faruk Sabanci & Aeden - Instanbul (Dereck Recay Remix) (Cut From Deynhoven Set)-enTc.mp3
Faskil - It Put Me To Sleep (Silence 'O' Phobia With Haazy's OMFG Remix) (Cut From Rivic Set)-enTc.mp3
Filth & Splendour - We Are Many (Cut From DPhrag Set)-enTc.mp3
Flavorsound - My Heart Is A Tempo (Original Mix) (Cut From Deep-Z Set)-enTc.mp3
Frangellico - La otra mejilla (Original Mix) (Cut From Ferreyra Set) (Â«â€¢Â»)-enTc.mp3
Front - Your Own Voice (Cut From Granddaddy Set)-enTc.mp3
Future Mode - New World Order (Precious Frequencies Remix) (Cut From Slang Set)-enTc.mp3
Garry Heaney - Zero Tolerance (Cut From PvD Set)-enTc.mp3
George Acosta - Something About You (M.I.K.E. Remix) (Cut From Wright Set)-enTc.mp3
George F - Eurovox (Bayyari & Mochizuki Remix) (Cut From Haazy Set)-enTc.mp3
George Soliis - Jazzylisious (Original Mix) (Cut From Python Set)-enTc.mp3
G-Tek - Majestic (Cut From Slang Set) (Â«â€¢Â»)-enTc.mp3
Guido Percich - Greenwich (Fernando Ferreyra Edit) (Cut From Ferreyra Set) (Â«â€¢Â»)-enTc.mp3
Hector Couto - Arabe (Cut From Acquaviva Set)-enTc.mp3
Hot Butter - Popcorn 2009 (Vanilla Creep Remix) (-96kbs- Cut From Piet Set)-enTc.mp3
Introcoda - Qwark (Original Mix) (Cut From Python Set)-enTc.mp3
Jamie Evans - Exploding Glass (Original Mix) (Cut From Deep-Z Set)-enTc.mp3
Javier Penna - Save A Prayer For Me (Cut From Serrao Set)-enTc.mp3
John O'Callaghan - Take It All Away (Ernesto vs Bastian Remix) (Cut From Raneem Set)-enTc.mp3
John O'Callaghan & Guiseppe Ottaviani - Liquid Fire (Temple One Remix) (Cut From Sied Set)-enTc.mp3
Joint Operations Centre - Cramped (Cut From Sherry Set)-enTc.mp3
Kassey Voorn - Groovelock (Original Mix) (Cut From Haazy Set)-enTc.mp3
Lacandon - Moma Robinja (Oliver Morgenroth Remix) (Cut From Bozman Set)-enTc.mp3
Leo Leal & The Royal Dance Project - Driven (Sasse Remix) (Cut From Benz Set)-enTc.mp3
Les Schmitz & Oliver Schmitz vs. Alex del Amo - Tasty (Andrea Bertolini & Spartaque Remix) (-96kbs- Set Rip)-enTc.mp3
Marc Mysterio Feat. Samantha Fox - Tomorrow (Future Disciple Trance Mix) (Cut From Kaneda Set)-enTc.mp3
Mariano Favre - Knight (Original Mix) (Cut From Ferreyra Set) (Â«â€¢Â»)-enTc.mp3
Markus Schulz - Do You Dream (Mr.Pit Re-Vision) (Set Rip)-enTc.mp3
Marninx - Remorse (Danjo Remix) (Cut From Pit Set)-enTc.mp3
Matias Chilano - Flashback (Original Mix) (Cut From Ferreyra Set)-enTc.mp3
Matias Chilano - Thinking (Cut From Slang Set) (Â«â€¢Â»)-enTc.mp3
Matias Chilano - Thinking (Original Mix) (Cut From Ferreyra Set) (Â«â€¢Â»)-enTc.mp3
Matt Darey Pres. Urban Astronauts - Black Flowers (Chase The Bunny Remix) (Set Rip)-enTc.mp3
Matteo Dimarr - Drumbotto (Cut From Benz Set)-enTc.mp3
Max Gueli - Jet Angel (Noyd's Peneropolis Remix) (Cut From Haazy Set) (Â«â€¢Â»)-enTc.mp3
Maxi Valvona - Revolve (Darin Epsilon Remix) (Cut From Cid Set)-enTc.mp3
Michael & Levan Feat. Stiven Rivic - Drive Me Crazy (Domased Electronica Remix) (Set Rip)-enTc.mp3
Michael & Levan Feat. Stiven Rivic - Invisible Children (Approaching Black Remix) (Set Rip)-enTc.mp3
Mike Shiver vs. Matias Lehtola - Snooze (Original Mix) (Cut From Sied Set)-enTc.mp3
Mike Sonar & Nivaya - Altercation (Oliver P. Remix) (Cut From Brandt Set)-enTc.mp3
Moonbeam Feat. Avis Vox - We Are In Words (Ashley Wallbridge Vocal Remix) (Set Rip)-enTc.mp3
MSQUARED - Rules. Meant. Broken. (Original Mix) (Set Rip)-enTc.mp3
Murcof - Rostro Kinky (Espectro Remix) (Cut From Igor Set)-enTc.mp3
Naomi Daniel - Feel The Fire (Deep Dish Burning Remix) (Cut From Morrison Set)-enTc.mp3
Neal Thomas - Pyro Techno (ASYS Remix) (Cut From Kamui Set)-enTc.mp3
Nicolas Coronel & Juan Pablo Graziano - Marea (Original Mix) (Cut From Ferreyra Set) (Â«â€¢Â»)-enTc.mp3
Niko Fantin - The Bad Shepard (Facundo Mohrr Remix) (Cut From Cid Set)-enTc.mp3
Niko Mayer - Smerillo (Original Mix) (Cut From Python Set)-enTc.mp3
Norin& Rad - Always A New Day (Cut From Pit Set)-enTc.mp3
Nurettin Colak - Compassion (Lee Haslam Remix) (Cut From Faruk Set)-enTc.mp3
Nurettin Colak - Compassion (Lee Haslam Remix) (Cut From Marlo Set)-enTc.mp3
Ormatie - O (Cut From Benz Set)-enTc.mp3
Ormatie - Thus And So (Cut From Benz Set)-enTc.mp3
Outlander - Vamp (Brent Sadowick Remix) (Set Rip)-enTc.mp3
P.T.M. - Own Movement (Original Mix) (-96kbs- Cut From Sheperd Set)-enTc.mp3
Pablo Acenso - Backgrounds (Mariano Favre Remix) (Cut From Ferreyra Set) (Â«â€¢Â»)-enTc.mp3
Paul Nasca - On and On (Vision 1 Julian Jeweil) (Cut From Tiesto Set)-enTc.mp3
Pete Tong & Dave Spoon - Gas Mask (Japanese Pop Stars Remix) (Cut From Morrison Set)-enTc.mp3
Pleasure Sound - God Bless (Ozgur Ozkan Remix) (Cut From Haazy Set)-enTc.mp3
Polly - Full Moon (Hypnotic Duo Remix) (Cut From Deep-Z Set)-enTc.mp3
Polly - Full Moon (Original Mix) (Cut From Ferreyra Set) (Â«â€¢Â»)-enTc.mp3
Praven Achery - Crossover (Fiord Remix) (Cut From Cid Set)-enTc.mp3
Prt Stacho - Collaboration (Cut From Benz Set)-enTc.mp3
Python - Enigma (Rasti Tkac & Musso Weaver Remix) (Cut From Deep-Z Set)-enTc.mp3
Python Feat. Cream Sound - Don't Save Me (Michael & Levan Feat. Stiven Rivic Remix) (Set Rip)-enTc.mp3
Radion 6 - Up We Go (Cut From SvD Set)-enTc.mp3
Rank 1 - Airwave (Mac & Taylor Remix) (Cut From Sherry Set)-enTc.mp3
Redloft & Matias Chilano - Anxiety (Yoonior Remix) (Cut From Audiokinetiks Set)-enTc.mp3
RedSound - Walking On The Beach (Angel Ace Remix) (Cut From Angel Set)-enTc.mp3
Re-Ward vs. Dr Willis - Whatever (Cut From Sherry Set)-enTc.mp3
Robert Babicz - Come Closer (Cut From Morrison Set)-enTc.mp3
Robert Vadney - The Last Falling Star (Cut From MaThOv Set)-enTc.mp3
Running Man - Fading Memories (Original Mix) (Cut From Angel Set)-enTc.mp3
Sasha - Omna (Nomad In The Dark Remix) (Cut From Cid Set)-enTc.mp3
Sasha Kaktus - Flashing Dope (Spieltape Remix) (Cut From Python Set)-enTc.mp3
Schiller - Dreams (Dj Ceratti & JP Graziano Remix) (Cut From Ferreyra Set) (Â«â€¢Â»)-enTc.mp3
Sean Marx - Do Mo Chailin (Cut From Slang Set)-enTc.mp3
Sean Tyas - UNTITLED (Cut From Tyas Set)-enTc.mp3
Sebastian Gudding & Admo - Late Night Theory (Cut From Ty Tek Set)-enTc.mp3
Sei A - Home (Deepchild Remix) (Cut From Igor Set)-enTc.mp3
Shaun Ansari - Luxuria (Suncatcherâ€™s Wave Motion Remix) (Cut From Wright Set)-enTc.mp3
Simon O'Shine & Sergey Nevone - Talitha (Original Mix) (Cut From Angel Set)-enTc.mp3
Skytech - Moonlit (Original Mix) (Set Rip)-enTc.mp3
Snake Sedrick - Here It Comes (Cut From Audiokinetiks Set)-enTc.mp3
Sneijder - Away From Here (Cut From JOC Set)-enTc.mp3
Spunktrixx - Night Train (Brent Sadowick Remix) (Cut From PvD Set)-enTc.mp3
Styller - Crossroads (Robert Burian Mashed) (Cut From Burian Set)-enTc.mp3
Sunset - Beautiful Life (Vol Deeman Remix) (Cut From Angel Set)-enTc.mp3
System F - Exhale (Fernieâ€™s Personal Revamp) (Cut From Wright Set)-enTc.mp3
System F - Out Of The Blue 2010 (Stoneface & Terminal Remix) (TATW 298 Rip) (Â«â€¢Â»)-enTc.mp3
Tasadi Feat. Aurielle - We Are Human (Omen Remix) (Cut From Anderson Set)-enTc.mp3
Tempo Giusto - UNTITLED (Cut From Synthika Set)-enTc.mp3
The Very Best - Kada Manja (Tim Green Remix) (Cut From Giust Set)-enTc.mp3
Thilo & Evanti - Decay & Release (Kamui Remix) (Cut From Kamui Set)-enTc.mp3
Thomas Gold - Squeeze (Alex Lamb Remix) (-Short- Cut From Stenberg Set) (Â«â€¢Â»)-enTc.mp3
Thomas Sagstad Pres Charlie & I - Grapefruit And Strawberries (Opuswerk Mix) (Cut From Benz Set)-enTc.mp3
Tiff Lacey - Show Me The Way (Ivan Spell Dub) (Cut From Flash Bro Set)-enTc.mp3
Tilt - The World Doesn't Know (PROFF Remix) (TATW 298 Rip)-enTc.mp3
Tom Glass - Helix Nebula (Cut From Benz Set)-enTc.mp3
Trilucid - We Are One (Liquid Visionâ€™s Upbeat Remix) (Cut From Wright Set)-enTc.mp3
Trim The Fat - The Heat Of Night (Original Mix) (Set Rip)-enTc.mp3
Tripmastaz - No Time To Loose (Cut From Giust Set)-enTc.mp3
Troy Hall - I Want You (Dirty Stalker Mix) (Cut From DPhrag Set)-enTc.mp3
Unkle - Trouble Heaven (Hernan Serrao Edit) (Cut From Serrao Set)-enTc.mp3
Vanghoul & Talmor - Minimal Toys (Original mix) (Cut From DPhrag Set)-enTc.mp3
Volodin Andre - First Layer (Original Mix) (Cut From Python Set)-enTc.mp3
Wippenberg - Pong (Sadowicks Re-Re-Re-Edit-Work Thing) (Set Rip)-enTc.mp3
Yofunk - J City (Karol Xvii & Mb Valence Remix) (Cut From Benz Set)-enTc.mp3
