 http://enigmat.webhop.net
.
Become a Fan of My Facebook Page --  by clicking LIKE -- for latest updates
.
.
Abstract Vision and Elite Electronic - UNTITLED (Cut From Abstract Set) (Â«â€¢Â»)-enTc.mp3
Ad Brown & Darin Epsilon - Cold Water (Playton Remix) (Cut From SlanG Set)-enTc.mp3
Adam Coppack & Akira Kayosa - Everything Ends (Suncatcher Remix) (ASOT 456 Rip)-enTc.mp3
Agnostic - Beyond The Sky (Cut From Mashkova Set)-enTc.mp3
Albert van Leizer & Jnks - Lost Dreams (Original Mix) (Cut From Shadows Set) (Â«â€¢Â»)-enTc.mp3
Ali Noori - Your Love (Dennis Pedersen Remix) (Cut From Pizz@dox Set)-enTc.mp3
Andrew Bennett feat. Sir Adrian - Run Till U Shine (Main Mix) (Set Rip)-enTc.mp3
Arty Pres. Alpha 9 - Come Home (Audien Remix) (Cut From Ferry Set)-enTc.mp3
Ayuda & Hind Feat. Twistigen - Sierra Leone (Apple One Remix) (Cut From Buff Set)-enTc.mp3
Calvin Harris - You Used To Hold Me (John Faruggio vs Laidback Luke Mashup) (Cut From Tiesto Set) (Â«â€¢Â»)-enTc.mp3
Cfunck - Just Chilin (Cut From SlanG Set) (Â«â€¢Â»)-enTc.mp3
CJ Peeton & Di - Love's Tapestry (Original Mix) (Cut From Lazarus Set)-enTc.mp3
Costa - High Above (Cut From LNQ Set)-enTc.mp3
D.E.R. & Julius Beat - Our Feeling (Stripwalker vs. Thomas Penton Remix) (Cut From Giusto Set)-enTc.mp3
Dan McKie vs Orbital - Halycyon Again (Dezza Remix) (Cut From Flash Bro Set)-enTc.mp3
Darren Tate & Jono Grant - LTLSI (Let The Light Shine In) (Arty Remix) (Cut From Arty Set)-enTc.mp3
Darte Rayne - Machine Gun (Original Mix) (Cut From Ronde Set)-enTc.mp3
Dave Schiemann - Elements (TATW 320 Rip) (Â«â€¢Â»)-enTc.mp3
Dave Wright - Ride The Storm (Cut From Ressiv Set)-enTc.mp3
Davey Asprey - Mindless (Original Mix) (Cut From Altuna Set)-enTc.mp3
Deep Sound - Just Deep (Cut From East Sun Set)-enTc.mp3
Depeche Mode - Peace (Peter Rauhofer Remix) -w- Panoptic - Surface (Cut From Warren Set)-enTc.mp3
Dimension - Queensland (The Airstatics Digital Remix) (Cut From Joop Set)-enTc.mp3
Dimension & Robbie Seed - Blue Line (Arisen Flame Remix) (Cut From Soundlift Set)-enTc.mp3
Dirty South Feat. Ruby - Phasing (Intro Edit) (Cut From Xijaro Set)-enTc.mp3
DJ Ange 113 (Michael Splint & Jox Remix) (Cut From Splint Set)-enTc.mp3
DJ Ives M & DJ T.H - More Nights In Neverland (Trance Arts Remix) (Cut From Kaneda Set)-enTc.mp3
DJ Observer, Heatcliff, Yuri Kane - Fake Call vs Be Right Back (Anhken Mash) (ASOT 456 Rip)-enTc.mp3
DK Project & Martin Pritchard - Clear Water (Original Mix) (Cut From Kaneda Set)-enTc.mp3
Dr Willis & Loki - Doppleganger (Cut From Colontonio Set)-enTc.mp3
Dresden & Johnston Feat. John Debo & Mezo Riccio - Keep Faith (Adam White Emalodic Club Mix) (Cut From Xijaro Set)-enTc.mp3
Dubfire Vs Oceanlab - Roadkill Satellite (Cut From Jules Set)-enTc.mp3
Ehren Stowers - Replicator (Cut From Buff Set)-enTc.mp3
Electric Traveller - Electric Traveller (Mike Shiver Garden State Remix) (Cut From Lemon Set)-enTc.mp3
Evave - Sun In My Hands (Set Rip)-enTc.mp3
Evave - UNTITLED 001 (Set Rip) (Â«â€¢Â»)-enTc.mp3
Evave - UNTITLED 002 (Set Rip) (Â«â€¢Â»)-enTc.mp3
EverLight - Vertigo (Original Mix) (Set Rip)-enTc.mp3
Favor - Groundswell (Cut From Kenji Set)-enTc.mp3
Ferry Tayle & Static Blue vs. Vast Vision - Trapeze Everything (Faruk Sabanci Mashup) (Set RIp)-enTc.mp3
From Tokyo With Love - Our Hearts Left In The Garden Of Silence (Kobana Remix) (Cut From SlanG Set)-enTc.mp3
Graham Gold - Living In The Now (Cut From Buff Set)-enTc.mp3
Hashish - Sunset On Sharm el Sheikh (Original Mix) (Cut From Soundlift Set)-enTc.mp3
Ian Betts Vs. Static Blue Reflections (Haris C Remix) (Cut From Splint Set)-enTc.mp3
Invisible Sounds & Faruk Sabanci feat. Debbie Digital - In The Summer (Electric Traveller Remix) (Set Rip)-enTc.mp3
Jade Synthman - Lost (Original Mix) (Cut From Ronde Set)-enTc.mp3
Jean Claude Ades - My Journey (Jerome Isma-Ae Remix) (ASOT 456 Rip)-enTc.mp3
Jer Martin vs. Armin van Buuren - Ten Minutes of Burning Desire (Andy Van Hall Mashup) (ASOT 450 Rip)-enTc.mp3
Joe Shadows & Charif Taymour - UNTITLED (Cut From Shadows Set) (Â«â€¢Â»)-enTc.mp3
John Askew - Chime (Ehren Stowers Remix) (Cut From Synthika Set)-enTc.mp3
John Miller - Viper (Original Mix) (Cut From Splint Set)-enTc.mp3
Karina Shustova - I'll Follow You (John Consalvo Uplifting trance Remix) (Cut From Martin Set)-enTc.mp3
Kayden - Black Emotion (Elias B Remix) (Cut From Soundlift Set)-enTc.mp3
Lasheen feat. Jwaydan - Sing with You (Strip Down Mix) (Cut From O'Neil Set)-enTc.mp3
Leon Bolier - UNTITLED (Nifra Remix) (Cut From Nifra Set)-enTc.mp3
Leon Bolier vs. JOOP - Fly Back To Her (747 Mix) (Cut From Joop Set)-enTc.mp3
Libertat - Maximus (Original Mix) (Cut From Soundlift Set)-enTc.mp3
Lior Levy - Way Down (Light Sequence Remix) (Cut From Fast Dist Set)-enTc.mp3
Lodos - Blur (Original Mix) (Cut From Ronde Set)-enTc.mp3
Lodos - Coward (Original Mix) (Cut From Ronde Set)-enTc.mp3
Luigi Lusini Feat. Novastar - Because We Are (Faruk Sabanci Mashup) (Cut From Del Mar Set)-enTc.mp3
Lurance - Unconsciousness (Juventa Remix) (Cut From Ferry Set)-enTc.mp3
Madonna - Frozen (Evave Bootleg Remix) (Set Rip)-enTc.mp3
Manida - Mesmerize (Original Mix) (Cut From Giusto Set)-enTc.mp3
Marco V & Mohawk - Spamarrest (Cut From Ferry Set)-enTc.mp3
Mark Arbor - 7 Suns (Adam Nickey Remix)  (TATW 320 Rip)-enTc.mp3
Marsbeing & Ange - Perfect Moon (Cut From East Sun Set)-enTc.mp3
Mathias Faint vs. Delirium - Hooverlist Silence (Arty Bootleg) ( (TATW 317 Rip)-enTc.mp3
Matt Eray - Lanai (Original Mix) (Cut From Shadows Set) (Â«â€¢Â»)-enTc.mp3
Mayson - Atmosphere (Cut From Abstract Set)-enTc.mp3
Mazzik - Remember (DSI Remix) (Cut From Abstract Set)-enTc.mp3
Mike Saint-Jules pres Saint X - Timeslider (Danilo Ercole Remix) (Cut From Wizz Set)-enTc.mp3
Miroslav Vriik - UNTITLED (Cut From Lemon Set)-enTc.mp3
Mistigris - Amour (Original Edit) (Cut From Ferry Set) (Â«â€¢Â»)-enTc.mp3
Moby - New York New York (Arty Remix) (Set Rip)-enTc.mp3
Moelamonde & Ian What Feat. Mque - In Your Arms (Original Mix) (Cut From Martin Set)-enTc.mp3
Moonbeam feat. Avis Vox - Storm Of Clouds (Evave Remix) (Set Rip)-enTc.mp3
Mr.9 feat. Oonagh Pres. Oriana - Bright Lights (Ian Buff Remix) (Cut From Buff Set)-enTc.mp3
Myk Bee - Skyline (Techtrik & Myk Remix) (Cut From Ronde Set)-enTc.mp3
Mysterious Movement - Another Chance (Original Mix) (Cut From Hytex Set)-enTc.mp3
New Pony Club Vs Remey - Stone (Josh Gabriel Mashup) (Cut From Gabriel Set)-enTc.mp3
P.O.S - Gravity (Sunny Lax Reload 2007) (TATW 320 Rip)-enTc.mp3
Paolo Avanti - Like Me (LavKastor Remix) (Set Rip)-enTc.mp3
Paul van Dyk, Starkillers & Austin Leeds Featuring Ashley Tomberlin - New York City (Markus Schulz Big Room Reconstruction) (- Pacha NYC - GDJB Rip)-enTc.mp3
Pedro Del Mar & Blue Tente - You Left (Ferry Tayle's Universal Language Remix) (Cut From Faruk Set)-enTc.mp3
Pete Silver - Castor & Pollux (Original Mix) (Cut From Saux Set)-enTc.mp3
PROFF - Albina (TATW 320 Rip)-enTc.mp3
Rank 1 & Jochen Miller vs. Yuri Kane - The Right Escape (Armin van Buuren Mashup) (ASOT 455 Rip)-enTc.mp3
RedSound - Blue Soho (Original Mix) (Cut From Soundlift Set)-enTc.mp3
Reflekt vs Deadmau5 - Need To Feel Cheese (DJR Mashup) (Cut From Tiesto Set) (Â«â€¢Â»)-enTc.mp3
Riki B - Down Under (Van Gelder Remix) (Cut From Ressiv Set)-enTc.mp3
Robbie van Doe - Sense Offender (Cut From Powers Set)-enTc.mp3
Robert Handelskai - Tone Of Spring (Cut From Mashkova Set) (Â«â€¢Â»)-enTc.mp3
Rocking J - Sonique (Cut From Flash Bro Set)-enTc.mp3
Ronny K. pres. Advanced - T.A.S.H (John Waver Remix) (Cut From Soundlift Set)-enTc.mp3
Ronny K. pres. Advanced - T.A.S.H. (Original Mix) (Cut From Mashkova Set)-enTc.mp3
Sandeagle - Polar Bear (Original Mix) (Cut From Shadows Set) -!-.mp3
Sander Kleinenberg - My Lexicon (Elke Klejin Remix) -w- Culoe de Song - The Brightest Forest (Cut From Warren Set)-enTc.mp3
Santerna - Waterway (Cut From East Sun Set)-enTc.mp3
Sebastian Moore - Armed (Original Mix) (Cut From Ferry Set)-enTc.mp3
Setrise - Devastate (Original Mix) (ASOT 456 Rip)-enTc.mp3
SHato - Final Exam (Kent & Gian Remix) (Cut From Sisi Set)-enTc.mp3
Shy Brothers - Recharge (Cut From Shy Bro Set) (Â«â€¢Â»)-enTc.mp3
Six Senses - Euphorica (Original Mix) (Cut From Soundlift Set)-enTc.mp3
SoundLift - Live From Above (Einar K Remix) (Cut From Tasev Set)-enTc.mp3
Stella - Broken Promises (LavKastor Vocal Mix) (Set Rip)-enTc.mp3
Stuart James - Art Deco (Oen Bearen & TrancEye Remix) (Cut From Powers Set)-enTc.mp3
Subsider - Look My Way (Original Mix) (Cut From Soundlift Set)-enTc.mp3
Suncatcher vs Pizz@dox - Remember the Youthful Years (Intro Mix) (Set Rip)-enTc.mp3
Susana feat. Jorn van Deynhoven - Never Mine (Dub Mix) (Set Rip)-enTc.mp3
Talla 2XLC vs. Robert Burian - Pro Life (Tempo Giusto Remix) (Cut From Giusto Set)-enTc.mp3
Tasadi - Jupiter (Masoud Remix) (Cut From Tasadi Set)-enTc.mp3
Tempo Giusto - Citizen Kane (Original Mix) (Cut From Giusto Set)-enTc.mp3
Tempo Giusto - Jekku (Original Mix) (Set Rip)-enTc.mp3
The Loneliness - Relaunch (Summerbreeze Remix) (Cut From Ronde Set)-enTc.mp3
The One Hundred - Break Me Down (Will Atkinson Remix) (Cut From Shy Bro Set)-enTc.mp3
The Prodigy - No Good (Start The Dance) (Da Fresh Boot) (Cut From Ferry Set)-enTc.mp3
The Remedy - Shot In The Dark (Mango pres. Shoreliners Remix) (Set Rip)-enTc.mp3
Thomas Kandinsky - Time Has Come (Original Mix) (Cut From Giusto Set)-enTc.mp3
Timo Juuti - Hypoactive (-Short- TATW 320 Rip) (Â«â€¢Â»)-enTc.mp3
Tomas de Bray - Colibri (Cut From Mashkova Set)-enTc.mp3
Tomas de Bray - Colibri (Original Mix) (Cut From Synthika Set)-enTc.mp3
Trim The Fat - Riding Rails (Cut From Flash Bro Set)-enTc.mp3
Ultimate - Storm (The Chaser Mix) (Cut From Abstract Set)-enTc.mp3
Vingretto - Vine (Paolo Avanti Remix) (-Short- Cut From Lavcastor Set)-enTc.mp3
Yousef - Come Home (Sasha Matterhorn Remix) (Set Rip)-enTc.mp3
