 http://enigmat.webhop.net
.
Become a Fan of My Facebook Page --  by clicking LIKE -- for latest updates.
.
Above & Beyond vs. Kyau & Albert - Anphonic (TATW 323 Rip)-enTc.mp3
Adrian West - Fire On The Floor (Original Mix) (Cut From Vemag Set)-enTc.mp3
August Vila - Tiquicia (Cut From KvA Set)-enTc.mp3
Barthezz - On The Move (Bart Claessen BCL 0310 Tokyo Bootleg) (Set Rip)-enTc.mp3
Ben Nicky Feat Linnea Schossow - Tears (Original Mix) (TATW 323 Rip)-enTc.mp3
Bryan Kearney - The Next Chapter (Fabio Stein's Uprise Remix) (-Short- Cut From Stein Set) (Â«â€¢Â»)-enTc.mp3
Carlo Lio - Musique (Cut From Schossow Set) (Â«â€¢Â»)-enTc.mp3
Chris Micali & Ali Ajami - Amazonia (Raxon Remix) (Cut From Saint-Jules Set)-enTc.mp3
Craving - Winter Reflections (Cut From Rank 1 Set)-enTc.mp3
Daniel van Sand - Live To Die Another Day (Tierra Remix) (Cut From Saint-Jules Set)-enTc.mp3
Droolotte Tasha featuring Trimix - Ravenous (Droolotte Tasha Re-Make) (Cut From Cyberian Soundz Set)-enTc.mp3
Easy Toys - Weekend Therapy (ASOT 459 Rip)-enTc.mp3
EDX - Thriev (Fe5tival Mix) (ASOT 459 Rip)-enTc.mp3
Erven Miller - Spring Breeze (Viceverse Remix) (Cut From Dinaire Set)-enTc.mp3
Fabio Stein - Techtris (-Short- Cut From Stein Set) (Â«â€¢Â»)-enTc.mp3
Faruk Sabanci - The Last Ottoman (Evol Waves Remix) (Cut From Stenberg Set)-enTc.mp3
Fei-Fei Feat. Molly Jenson - Twilight (Tyler Michaud Broken Machine Intro Mix) (-Short- Cut From Rank 1 Set)-enTc.mp3
Filth Splendour vs. Harry Brown - Infinity (Cut From Rank 1 Set) (Â«â€¢Â»)-enTc.mp3
Flavio Grifo - Coideloko (Danny Loko Remix) (-Short- Cut From Stein Set) (Â«â€¢Â»)-enTc.mp3
Jaiden - To Be Unknown (Clash Remix) (Cut From Rank 1 Set)-enTc.mp3
Jonesey - Independance (Indecent Noise Dirty Secret Rework) (Cut From Wales Set)-enTc.mp3
Kobana - The First Attempt (Basil O Glue Remix) (Cut From Vemag Set)-enTc.mp3
Krazy Sandi - Insanity (Arctic Moon Remix) (ASOT 459 Rip)-enTc.mp3
Lost Connection - Velvet Night (Original Mix) (TATW 323 Rip)-enTc.mp3
Lost Connection - Velvet Night (Sensitize Remix) (ASOT 459 Rip)-enTc.mp3
Magdelayna - We Lived A Lifetime (Original Mix) (Set Rip)-enTc.mp3
Magikal Feat. Lydia - Love Takes Time (Liquid Vision Dub N Tech Edit) (Cut From Rutkovski Set)-enTc.mp3
Mark Eteson - Blackboard (TATW 323 Rip)-enTc.mp3
Mark Junior - Natural (Aaron Camz Remix) (Cut From Rank 1 Set)-enTc.mp3
Mike Danis - Inner Beauty (Angel Ace Remix) (TATW 323 Rip)-enTc.mp3
Mike Shiver vs Fandy - Sique (Original Mix) (TATW 323 Rip)-enTc.mp3
Orjan Nilsen - So Long Radio (Aurosonic Overdrive Mix) (ASOT 459 Rip)-enTc.mp3
Ozgur Can - UNTITLED (Cut From Schossow Set) (Â«â€¢Â»)-enTc.mp3
Peter Johansson - Fourth Street (Cut From Saint-Jules Set)-enTc.mp3
Pnau Feat. Ladyhawke - Embrace (Miami Horror & Fred Falke Remix) (Cut From Stenberg Set)-enTc.mp3
Push - Strange World (George Vemag Remix) (Cut From Vemag Set)-enTc.mp3
Richard Sander - Heaven (Cut From Sugar Set)-enTc.mp3
Sam Stroke & Isaac Fisherman - Back Forever (Cut From Kaeno Set)-enTc.mp3
Setrise & Matthew Nagle - Reckless (Cut From Woods Set) (Â«â€¢Â»)-enTc.mp3
Shogun Feat. Emma Lock - Save Me (Dub Mix) (Cut From MIKE Set)-enTc.mp3
Simmons & Blanc - Whatever It Takes (ASOT 459 Rip)-enTc.mp3
Spada - Mistery Box (Ricky Fobis Remix) (Cut From Schossow Set) (Â«â€¢Â»)-enTc.mp3
Stana - Circus (Jonas Stenberg Remix) (Set Rip)-enTc.mp3
Temple One - Autumn Leaves (Club Dub) (TATW 323 Rip)-enTc.mp3
The Hague - Crank (Original Mix) (-Short- Cut From Stein Set)-enTc.mp3
