Fox Partymixe Folge 1 by DMXCrewâ„¢

CD1
01. Uwe Busse - Das geht vorbei (Disco-Mix)                       
02. Bernhard Brink - Super Geile Zeit (Remix)                     
03. Simone - 1000 mal getraeumt (Party Mix)                       
04. Markus - Alles kommt wie es kommt (German Dance Mix )         
05. Wind - Radio Zuckerhut (Remix)                                
06. Christian Lais - Ihr Ring liegt noch hier (Dance Mix)         
07. Olaf Berger - Kopf oder Zahl (Club-Mix)                       
08. Nicki - Endlich Sommer (DJ-Mix)                               
09. Fantasy - Keine Luegen                                        
10. Oliver Thomas - Rosenrot (Disco Mix)                          
11. Ingrid Peters - Deine Kuesse (Remix)                          
12. Isabel Varell - Nachts (Remix)                                
13. Andreas Zaron - Tick Tack (Tag und Nacht) (Remix)             
14. Andrea JÃ¼rgens - Zurueck aus meinem Traum (Disco Mix)         
15. Klaus Wendel - Einmal heisst keinmal (Disco Mix)              
16. Uta Bresan - Ab in den Sueden (Sommer-Mix)                    
17. Marty Kessler - Ab morgen will ich nicht mehr Single sein     
18. Cliff & Rexonah - Das ganz groÂ§e Glueck (Kurztanzmix)         
19. Tommy Steiner - Spiel mit mir Liebe (Ext. Version)            
20. Vivian Lindt - Du tust mir gut (Disco Mix)                    

CD2
01. Brunner & Brunner - Alle wollen immer nur das Eine (Party Mix)                   
02. Neue zeiten - Eine Nacht (die nie zu Ende geht) (Fox Mix)                        
03. Nic - Es steht in deinen Augen (Disco Version)                                   
04. Sandy Wagner - Joana trÃ¤umt (DJ-Short Mix)                                       
05. Frank Lars - Du liebst ihn doch noch immer (Disco Mix)                           
06. Leonard - Wer weiss denn schon was SÃ¼nde ist (Club Mix)                          
07. Oliver Frank - Wie ein Engel (Disco Mix)                                         
08. Jens Bogner - Feuer und Flamme (Club Version)                                    
09. Edwina de Pooter - Genau der Mann (Disco Mix)                                    
10. Matthias Carras - Diva (fresh Fox Mix)                                           
11. Nico Gemba - Der letzte Fox (Reloaded)                                           
12. Wilde Herzen - 1000 LÃ¼gen (Fresh Fox Mix)                                        
13. Xandra Hag - Ergib dich - ich lieb dich (Radio Remix)                            
14. Bruno Ferrara - Amore Mio (Disco Fox Mix)                                        
15. Andy Fox - Nehm wir mal an (Disco Mix)                                           
16. Nicole Freytag - Jeder Weg beginnt mit einem ersten Schritt (Disco-Fox Maxi)     
17. Andreas Lebbing - An einer Dosis Liebe stirbt man nicht (Remix)                  
18. Silvia Martens - Manchmal braucht die Liebe Zeit (DJ Mix)                        
19. Gerd Christian - GlÃ¼ck lebt in unseren Herzen (Club Mix)                         
20. Anke Lautenbach - Spiegelbilder (Club Mix)                                    