Born To Expire:

1. Rise and Fall  	          7. Tools For War
2. Mark of the Squealer 	  8. Born to Expire
3. Be Loud 	                  9.  Marathon
4. On the Outside                 10. Self Defense
5. Defy You 	                  11. Catholic High School (Girls in Trouble)
6. Enforcer 	                  12. Unexpected

Desperate Measures:

1. Make Me an Offer  	          6. Kingpin
2. All About Dope 	          7. Who's to Blame
3. Soft Way Out 	          8. Ball Hugger
4. Stand For 	                  9. 2 Minute Warning
5. No Heroes 	                  10. The Future (Ain't What It Used to Be)

Adult Crash:

1. Simple Life?  	          6. 10 Years
2. You 	                          7. Silver Tongue
3. Make a Move 	                  8. Grip
4. 3 Wishes 	                  9. The Roulaison
5. Withering Heights 	          10. Clueless

Open Mouth Kiss:

1. Foot the Bill  	          7. State
2. Hornet's Nest 	          8. The Old Man of Sorrows
3. Product 	                  9. I Believe
4. Jock Hop Show 	          10. Comes Back to Haunt
5. Compromise 	                  11. Novena
6. Manufabricate


Please seed!!!!