This was manually ripped by ReeO. 

Providing good quality torrents takes time! Please show your support by SEEDING this for as long as you possibly can. 

One Love's Description: 

ItΓÇÖs that sun-drenched time of year again, and ONELOVE's massive 3 disc release MOBILE DISCO is back for 2010. Summer, festivals, sand, surf ΓÇª all the things that we are proud to call Summertime in Australia are right on our doorsteps, and this year the best DJ's in the world are playing at your party! Onelove welcomes John Dahlback, the Bang Gang Deejays & Andy Murphy up to the decks to deliver the sounds to drive around town with the sunroof open, and to keep the beach house bouncing all summer long. 

MOBILE DISCO 2010 isnΓÇÖt short on the stand out party soundtracks either, featuring tracks and remixes from the best in the biz including Martin Solveig, Dragonette, Calvin Harris, The Gossip, Armand Van Helden, A-Trak, Yeah Yeah Yeahs, Eric Morillo, Fedde Le Grand & more. 

Tracklisting: 

Disc 1 - Mixed By Andy Murphy: 

Calvin Harris - Flashback 
Martin Solveig Feat Dragonette - Boys & Girls 
Paloma Faith - Stone Cold Sober (Cicada Remix) 
Armand Van Helden - The Funk Phenomena (Starkillers 2009 Remix) 
Burns - In My Eyes (His Majesty Andre Remix) 
Phonat - Set Me Free (Matt Nugent Remix) 
Tj Flayerz - Ride On Time 2009 (No Moon Remix) 
Reekay Garcia - Back To The Beat 
Zoot Woman - Just A Friend Of Mine (Chris Fraser Remix) 
Carl Kennedy - Rocknrolla 
Julian The Angel - Jaguar 2009 ( Remix) 
Andy Murphy - Music Master 
D.I.M. & Tai - Lyposuct (Noob Remix) 
Stuffa Feat Ram Di Dam - A Million Secrets (Club Mix) 
Chardy & Christian Luke - Because We Can 
Moguai - Zyvox 
Edx - Shy Shy (Club Mix) 
Fatboy Slim Vs Fedde Le Grand - Praise You 2009 (F.L.G Remix) 
Lauren Flax Feat Sia - You've Changed (Dean Coleman Village Vocal) 

Disc 2 - Mixed By John Dahlback: 
Bingo Players - Devotion 
Gel Abril - Marir (Original Mix) 
Martijn Ten Velden & Afroboogie - Cowbell (Edit) 
Hugg & Pepp Feat. Robert Manos - Sweet Rosie ( Henrik B Remix ) 
Michel Cleis Featuring Totola Momposina - La Mezcla (Copyright Main Mix) 
Muzzaik - Going Underground 
Gel Abril - Spells Of Yoruba (Original Mix) 
Erick Morillo Featuring Deborah Cooper - I Get Lifted (Dronez Dub Edit) 
John Dahlback Featuring Terri B! - Flirt (Club Mix) 
Lake & Lys - La Tromba 
Wolfgang Gartner - Latin Fever 
Tim Berg - Alchoholic 
Franceso Diaz & Young Rebels - Into The Night (Club Mix) 
Cirez D - On / Off 
John Dahlback featuring Andy P - Love Inside (Dub Instrumental) 
Rene Amesz - Da Slick 
Da Mongoloids - Spark Da Meth (Atfc's Wildstyle Remix) 
John Dahlback - Valleybrook (Extended Mix) 
Bingo Players Featuring Dan'thony - I Will Follow (Theme Fit For Free Dance Parade) 
Taped - The Question (Albin Meyers Remix) 
Fedde Le Grand Feat. Mitch Crown - Let Me Be Real (Hook N Sling & Goodwill Remix) 

Disc 3 - Mixed by Bang Gang Deejays (Doom & Hoodrat): 
Intro - Bang Gang Deejays 
Tiga - What You Need (Zombie Nation Remix) 
The Young Lovers - Love You Madly 
The Faint - Machine In The Ghost (DJEDJOTRONIC Remix) 
Beni feat. Sam Sparro - Maximus (Bang Gang Remix) 
DJ Gregory & Gregor Salto - Con Alegria (Solo 'More Cowbell' Remix) 
Felix Da Housecat - Elvi$ (Original Mix) 
Knightlife - Discotirso 
Mr Oizo - Gay Dentists 
Gossip - Love Long Distance (Riva Starr Remix Vocal) 
MODESELEKTOR - Suckerpin (Feadz Remix) 
Style of Eye - Grounded (Original) 
Hystereo - Cityspeak (Arveene & Misk Remix) 
Hey Today! - If I Was Wonderman (Vanshe Tech Remix) 
The Lowbrows - Dream in The Desert (Hystereo Rebrand) 
Yeah Yeah Yeahs - Heads Will Roll (A-Trak Remix) 
Zombie Nation - Radio Controlled (Hey Today! Remix) 
Joakim - Watermelon Bubblicious 
Still Going - Spaghetti Circus 
Golden Bug - Last Dance in Tokyo (Gloves Rewrite) 
Das Glow - I Want To Wake Up With You
 
http://www.onelove.com.au/component/content/article/51-recordings-front-page/256-mobile-disco-2010-r-u-ready-for-the-summer