
Backxide - The Oldschool Power

Tracklist

ATB - Bring it
Desireless - Voyage Voyage '98
Dj Ballon - Blow Job (Bassline Mix)
2 Brothters On The 4th Floor - Fly
666 - Amokk
Sash! - Ecuador (Bruce Wayne Mix)
Dr Alban - It's My Life (Sash! RMX)
DNS - Earth Move
Dj Visage - Formula
Gardeweg - Push (Club mix)
Gorgenous - Don't Stop
Dr Alban - Mr Dj
Dj Qiucksilver Meets Shaggy - Bombastic (Deep Club Mix)
Dj Roman - A Pitar
Dj Jean - Love Come Home (Klubheads Mix)
Cosmo & Tom - Popcorn
Cynical Blend - Wooden Deck's
Dj Jo - Sweet Dream's (7' Cut Mix)
Brooklyn Bounce - Canda (Olav Basoski Rmx)
Cappella - Move On Baby
Kerozin - Full House TÃ©boly (Hungary)
Hypertrophy - Pullover (X-tendedmi-X)
N.Y.C.C - Can you feel It (Rock Da House  Junkfood Junkies Remix)
Lightforce - Take Up Your Time (Club Attack)
Fun Factory - Prove Your Love

Quality : 192 kbps 44kHz Stereo
Website :

Have Fun!