 http://enigmat.webhop.net
.
Become a Fan of My Facebook Page --  by clicking LIKE -- for latest updates
.
.
7 Skies & Kiholm - Lost & Found (Dan Stone Remix) (Cut From Holland Set)-enTc.mp3
Adam Sheridan - GTM8 Manila (Cut From ASYS Set)-enTc.mp3
Adriz - Final Second (Matt Church & Kevin Shepherds Sunset Mix) (Cut From Kaneda Set)-enTc.mp3
Afrojack - Hide & Seek (Original Mix) (-LQ- Cut From Tiesto Set) (Â«â€¢Â»)-enTc.mp3
Alex & Filip Feat. Alec Sun Drae - Tell Me (Steve Haines Remix) (Set Rip)-enTc.mp3
Alex M.I.F. - Heavently Angel (Laura May Remix) (Cut From Anna Lee Set) (Â«â€¢Â»)-enTc.mp3
Ali WIlson - Danger (Ruff 'n' Tufff Remix) (Cut From Rank1 Set)-enTc.mp3
Andy Moor & Andy White Pres. Whiteroom feat. Amy Cooper - Someday (Orjan Nilsen Remix) (Set Rip)-enTc.mp3
Andy Tau & Touch Enable Feat. Louisa Allen - Sorry (Adam Kancerski Remix) (Cut From Feel Set)-enTc.mp3
Angel Ace - St Thomas (Stonevalley Remix) (Cut From Holland Set)-enTc.mp3
Anton Catalin - Always Lost (Kenneth Thomas Remix) (Cut From Pledger Set)-enTc.mp3
Anton Catalin - UNTITLED (Cut From Jussi Set)-enTc.mp3
Audien - November (Tommy Baynen Remix) (TATW 318 Rip)-enTc.mp3
Audien - Transition (Paul Tarrant Remix) (Cut From Ronski Set)-enTc.mp3
B.Y.O.B vs. J Majik & Wickaman - Save My Life (Lazy Rich Instrumental Mix) (Cut From Darey Set)-enTc.mp3
Beat Factory - Roswell (Inkfish Remix) (Cut From Blusoul Set)-enTc.mp3
Ben Preston feat. Susie - Remember Me (ID Mix) (Cut From Pledger Set)-enTc.mp3
Ben Preston feat. Susie - This Feeling Inside (Robert Burian Remix) (Cut From Ferry Set)-enTc.mp3
Bootek Dj's - Take That (Bootek 44) (Cut From Yoji Set)-enTc.mp3
Brian Hope - Deep Waters (Cut From Saint-Jules Set)-enTc.mp3
Bushi - 23 Kisses (Jussi Soro Remix) (Cut From Feel Set) (Â«â€¢Â»)-enTc.mp3
Cid Inc. - Refrost (Steve Haines Remix) (Set Rip)-enTc.mp3
Cliff Coenraad - Obsession For More (Cut From Ferry Set) (Â«â€¢Â»)-enTc.mp3
Dada Life - Cookies with a Smile (Fracesco Diaz & Young Rebels Remix) (Cut From O'Neil Set) (Â«â€¢Â»)-enTc.mp3
Dash Berlin - Feel U Here (Paul Trainer Remix) (Set Rip)-enTc.mp3
Dash Berlin Feat. Solid Sessions - Janeiro (Signum Remix) (Cut From Ferry Set)-enTc.mp3
Dave Shifting - My Way (Oliver Imseng Remix) (Cut From Saux Set)-enTc.mp3
Der Mystik & Tiff Lacey - Watching The World (Progressiver Remix) (Cut From Anna Lee Set)-enTc.mp3
Des McMahon - Crack The Whip (Cut From PvD Set) (Â«â€¢Â»)-enTc.mp3
Desser - Pick Me Up (Cut From Pledger Set)-enTc.mp3
D-Folt - Effects of Infinity (John Askew Rework) (Set Rip)-enTc.mp3
Dinka - Aircraft (TATW 318 Rip)-enTc.mp3
DJ Densky - Sky Gate (Cut From Trancis Set)-enTc.mp3
DJ Tiesto - Traffic (Richard Durand Remix) (-SAMPLE-)-enTc.mp3
Dresden & Johnson & Nadia Ali - That Day (Myon & Shane 54 Club Mix) (Set Rip)-enTc.mp3
Dresden & Johnston - Keep Faith (Lenny Ruckus & Ana Vida Remix) (Cut From Del Mar Set) (Â«â€¢Â»)-enTc.mp3
Edu - Purple Rose (Cut From O'Neil Set)-enTc.mp3
Electrobios, The Flyers & Mike Sonar - Deep in The Heart (Original Mix) (-96kbs- Set Rip)-enTc.mp3
Electrovoya - Earth Rise (Original Mix) (Cut From Feel Set) (Â«â€¢Â»)-enTc.mp3
Eugene Kush - Asanva (Original Mix) (Cut From Feel Set)-enTc.mp3
Fabio Stein - In The West (DJ Jack Pres. JK5 'El Sherifon' Remix) (Set Rip) (Â«â€¢Â»)-enTc.mp3
Faithless - Insomnia (Kristoff B2TF Remix) (Set Rip)-enTc.mp3
Fast Distance - Last Night Without You (Asbjorn Hegdahl Remix) (Cut From Jussi Set)-enTc.mp3
First State - As You Were { Are } (Ben Nicky Remix) (Cut From PvD Set)-enTc.mp3
Frank Ellrich - Acid Phonk (Cut From ASYS Set) (Â«â€¢Â»)-enTc.mp3
Future Scope - 120 Days Later (Original Mix) (Set Rip)-enTc.mp3
Future Scope - The Ones That Stay (Original Mix) (Set Rip)-enTc.mp3
Gatty - Grease Monkey (Cut From ASYS Set)-enTc.mp3
George Acosta - Elastic People (Carlo Calabro Remix) (Cut From Rank1 Set)-enTc.mp3
George Acosta - Elastik People (Space Rockerz Remix) (Cut From Saint-Jules Set)-enTc.mp3
Gregori Klossman and Danny Wild - Kixxx (Original Mix) (-LQ- Cut From Tiesto Set)-enTc.mp3
H2at - Getaway (Magitman Remix) (Cut From Haines Set)-enTc.mp3
Halifax - Reveal Your Innocence (Matt Millon Remix) (Cut From Ferry Set)-enTc.mp3
Hertz - A Voice Of My Own (Petter B Remix) (Cut From Solarstone Set)-enTc.mp3
Ich Und Ich - Stark (Jay B Remix) (Cut From Eyden Set)-enTc.mp3
Illitheas - Waiting (Ciro Visone Remix) (Cut From Del Mar Set)-enTc.mp3
Ilya Soloviev - Echo (Original Mix) (Cut From Ilya Set) (Â«â€¢Â»)-enTc.mp3
Inna - Amazing (DJ Feel Instrumental Mix) (Cut From Feel Set) (Â«â€¢Â»)-enTc.mp3
Ivan Nikusev & Wav-E - Strings Of Life (Eryo Remix) (Cut From Phon Deep Set)-enTc.mp3
Jager Meisters - Jager Meister (Nhato Bootleg) (Set Rip) (Â«â€¢Â»)-enTc.mp3
Johan Ekman - Lifebreak (A.T.M Remix) (Cut From Kaneda Set)-enTc.mp3
John Askew - Misfit (Adam Foley Heads Up Mix) (Cut From Askew Set)-enTc.mp3
Juniperro Serra - The Ferry Man (Night Liberator Remix) (Cut From Yoji Set)-enTc.mp3
Justice vs Simian - We Are Your Friends (ID Remix) (-LivE- Cut From Tiesto Set)-enTc.mp3
Keith Hurtigan - House Yo (ID Mix) (Cut From Pledger Set)-enTc.mp3
Kid Cudi vs MGMT - The Pursuit Of Happiness (Steve Aoki Remix) (-LivE- Cut From Tiesto Set)-enTc.mp3
Kyohei Akagawa & Taishi - Gymnopedies (Set Rip) (Â«â€¢Â»)-enTc.mp3
La Roux - Quicksand (AN21 & Philip Jensen Remix) (-LQ- Cut From Tiesto Set)-enTc.mp3
Lange Feat. Emma Hewitt - Live Forever (Mat Zo Dub Mix) (Cut From O'Bir Set)-enTc.mp3
Larrakin - Breaking Love (Original Extended Mix) (Cut From Del Mar Set)-enTc.mp3
Las Salinas - San Antonio (Cut From PvD Set)-enTc.mp3
Lustral - Everytime (Stephan Grondin's Mix) (Cut From Stein Set)-enTc.mp3
Majai - Emotion Flash (Sunny Lax Remix) (TATW 318 Rip)-enTc.mp3
Marc Simz Vs. Aerofoil - Lost In NY (Original Mix) (Cut From Saint-Jules Set)-enTc.mp3
Marcus Ulman - Flip Switch (Dessau Remix) (Cut From Pledger Set)-enTc.mp3
Mark Young & Derek Jones - Vengeance (Neal Thomas Remix) (Cut From ASYS Set)-enTc.mp3
Matt Holliday Pres. Resinity Feat. Mque Your Touch (Adam Nickey Dub) (TATW 318 Rip)-enTc.mp3
Nate R & Griff O'Neill - Nightfall (Original Mix) (Cut From Audien Set)-enTc.mp3
Nhato - FF13 (Set Rip)-enTc.mp3
Nhato - Ghost In The Shell (Set Rip) (Â«â€¢Â»)-enTc.mp3
Nhato - Last Duty (Set Rip) (Â«â€¢Â»)-enTc.mp3
Nhato - Tokyo Blue Pipe (Progtech Mix) (Set Rip) (Â«â€¢Â»)-enTc.mp3
Nick Dacosta - Starjump (Castas Dubstep Remix) (Cut From Shah Set)-enTc.mp3
Nicky C Feat. Ian Ross - Deja Vu (Inkfish Remix) (Cut From Blusoul Set)-enTc.mp3
Oliver P Pres. Stonevalley - Someone Else (Original Mix) (Cut From Shah Set)-enTc.mp3
Orjan Nilsen - Lovers Lane (Cut From Schossow Set)-enTc.mp3
Ozgur Ozkan - Black N White (Blusoul Remix) (Cut From Blusoul Set) (Â«â€¢Â»)-enTc.mp3
Pandas Dream - Sauda Song (Front Remix) (Cut From Del Mar Set)-enTc.mp3
Pants & Corset - Malice In Wonderland (Lee Haslam Remix) (Set Rip)-enTc.mp3
Paul Oakenfold - Sex And Money (Adam White Stripe Mashup) (Cut From Oakenfold Set)-enTc.mp3
Paul Oakenfold - The Harder They Come (Robert Vadney Remix) (Cut From Oakenfold Set)-enTc.mp3
Pete Da Zouk, Abigail Bailey & Mastercris - I Am Back Again (Original Extended Mix) (Cut From Del Mar Set)-enTc.mp3
PROFF - Abandoned (TATW 318 Rip)-enTc.mp3
Proff - UNTITLED (Cut From Rosen Set)-enTc.mp3
Progressence - Beautiful Dream (Original Mix) (Cut From Shah Set)-enTc.mp3
Progressiver Pres. FineSky - Clarity in Our Fate (Original Mix) (Cut From Anna Lee Set)-enTc.mp3
Project 6 - Beyond Compare (Cut From M6 Set)-enTc.mp3
PYUR - Hold (Alexander Kostruba Remix) (Cut From Blusoul Set)-enTc.mp3
R.O.O.S. - Instant Moments (Robert Vadney Remix) (Cut From Oakenfold Set)-enTc.mp3
Robert Vadney - Gothansia (Cut From Oakenfold Set)-enTc.mp3
Roger M. Feat. Eva - So Into You (Jonas Steur Remix) (Cut From Pledger Set)-enTc.mp3
Schamakh & LCK - My World (Soren Andrews 2 Faced Remix) (Cut From Peteerson Set)-enTc.mp3
ScorpiuS - Storm Tears (Cut From Feel Set) (Â«â€¢Â»)-enTc.mp3
Shato - Final Exam (Espen Lorentzen Remix) (Cut From Ilya Set)-enTc.mp3
Shogun - City Of Angels (Cut From Ferry Set)-enTc.mp3
Six Senses pres. Factor Six - Microtonic (Garry Heaney Remix) (Cut From Rogers Set)-enTc.mp3
Smart Apes Feat. Kate Miles - UNTITLED (Cut From Anna Lee Set) (Â«â€¢Â»)-enTc.mp3
Snow Patrol - Chasing Cars (Blake Jarell 2010 Remix) (-LQ- Cut From Tiesto Set)-enTc.mp3
Solarity - Part Time Hero (TATW 318 Rip)-enTc.mp3
Solis - Cascade (Original Mix) (Cut From Saux Set)-enTc.mp3
Something Good vs Red Carpet - Studio Alright (SG Bootleg) (Cut From Pledger Set)-enTc.mp3
Stana - Sleep Creep (Cut From ASYS Set)-enTc.mp3
Storm aka Scorpius - Tears 3 (Cut From Feel Set)-enTc.mp3
Sydney Blu & vitaminsforyou - Aeroplane (Paul Thomass Dex In The City Remix) (Cut From Darey Set)-enTc.mp3
System F - Solstice (Jonas Stenberg Remix) (Cut From Schossow Set)-enTc.mp3
The Flyers & Mike Sonar - One Story (Original Mix) (Set Rip)-enTc.mp3
The Orange Feat. Ksenia Lorents - About Sex (Deep Night Mix) (Cut From Feel Set)-enTc.mp3
The Prodigy - Smack my Bitch up (AN21 Bootleg) (-LQ- Cut From Tiesto Set)-enTc.mp3
The Roc Project Feat. Tina Arena - Never (Paul Miller Vs Ronald de Foe 2010 Remix) (Set Rip)-enTc.mp3
The Thrillseekers - Synaesthesia (The Thrillseekers Live Xtreme Mix) (TATW 318 Rip)-enTc.mp3
Tiesto Feat. Diplo - Come On (-LivE- Cut From Tiesto Set)-enTc.mp3
Tiesto feat. Kirsty Hawkshaw - Just Be 2010 (Remix) (-LQ- Cut From Tiesto Set) (Â«â€¢Â»)-enTc.mp3
Timo Garcia Feat. Amber Jolene - Lady Luck (Cut From Darey Set)-enTc.mp3
Timo Garcia Feat. Amber Jolene - Lady Luck (Matt Lange Remix) (Cut From Darey Set)-enTc.mp3
Torin Schmitt Feat. Ryan Merchant - Follow (Stonevalley & Khaomeha Uplifting Mix) (Cut From Holland Set)-enTc.mp3
Tritonal Feat. Soto - Forgive Me, Forget You (Cressida Remix) (Cut From Pledger Set)-enTc.mp3
Underwater & Ronald de Foe pres. Monotape Feat Aneym - Everything Continues  (Original Vocal Mix) (Set Rip) (Â«â€¢Â»)-enTc.mp3
Underworld - King Of Snake (Woody Van Eyden Remix) (-Sample-)-enTc.mp3
UNKNOWN - Chimes (Cut From Yoji Set)-enTc.mp3
Wellenrausch - No Superstition (Simmons & Blanc Remix) (Cut From Schossow Set)-enTc.mp3
Will Atkinson - Lights Out (Lee Haslam Remix) (Set Rip)-enTc.mp3
XGenic - Oracle Dream (UNKNOWN Remix) (Set Rip)-enTc.mp3
Yenn - Monzen (Stoneface & Terminal Remix) (NEW Set Rip)-enTc.mp3
Yuri Kane - Right Back (Intro Mix) (Cut From O'Neil Set)-enTc.mp3
