Beethovens tvÃ¥a (1993)

Beethoven Ã¤r tillbaka! Den hÃ¤r gÃ¥ngen drabbas han av den stora kÃ¤rleken - Missy

Fakta om filmen
Originaltitel

Beethoven's Second

Land, Ã¥r, lÃ¤ngd
USA Ã¥r 1993, 86 min

RegissÃ¶r

Rod Daniel
Manus

Len Blum
SkÃ¥despelare

Charles Grodin - George Newton
Bonnie Hunt - Alice Newton
Nicholle Tom - Ryce Newton
Christopher Castile - Ted Newton
Sarah Rose Karr - Emily Newton
Debi Mazar - Regina
Chris Penn - Floyd
Ashley Hamilton - Taylor
Danny Masterson - Seth
Catherine Reitman - Janie
Maury Chaykin - Cliff Klamath
Heather McComb - Michelle
Scott Waara - Banker
Jeff Corey - Janitor
Virginia Capers - Chemistry Teacher
Devon Gummersall - Baseball Captain
Jason Perkins - Baseball Captain
Jordan Bond - Newspaper Boy
Robert Cavanaugh - Party Guy
Randall Slavin - Party Guy

Produktions info

Steven Jacobs - CASTING

Bill Butler - FOTO

Sheldon Kahn - Klippning

William D. Gordean - Klippning

April Ferry - Kostym

Randy Edelman - Musik



