SEPHIROTHTRANCE [VOLUME 05] (2009-10-02)

Artist...................: Various
Title....................: SephirothTrance [Vol 05]
Genre....................: Techno, Trance, Club, House, Psychadelic & Dance
Year.....................: 2009
Channels.................: 2 (Stereo) & (Dual Channels)
Sample Rate..............: 44,1 KHz
Sample Size..............: 16 Bit
Encoder..................: LAME 3.98r
Encoder Settings.........: Variable Bit Rate -V 2 (Standard)
Covers...................: Front
Tags.....................: Proper In The Files

Tracks:

Above & Beyond Pres. OceanLab - Sirens Of The Sea [Ft. Justine Suissa] [Above & Beyond Club Mix]
Activa Vs. Chris & Matt Kidd - U.R. [Stoneface & Terminal Remix]
Andy Moor & Ashley Wallbridge - Faces [Ft. Meighan Nealon] [Tenishia Remix]
Armin Van Buuren - Broken Tonight [Ft. Van Velzen] [Original Mix]
Armin Van Buuren - Burned With Desire [Ft. Justine Suissa] [Rising Star Vocal Mix]
Armin Van Buuren - In And Out Of Love [Ft. Sharon Den Adel] [The Blizzard Remix]
Armin Van Buuren - Touch Me
Armin Van Buuren Pres. Gaia - Tuvan [Original Mix]
Atlantis Ocean - Crossroads [Original Mix]
Bananarama - Look On The Floor / Hypnotic Tango [Angel City Short Mix]
Basshunter - Every Morning
Bedrock - Heaven Scent  [Greg Downey Remix]
Big Ang - Wifey [Ft. Sibhan]
Blake Jarrell - Boracay [Venaccio Remix]
Bryce Vs. Shaun Baker - Blame It On The Summer
BT - Every Other Way [Ft. Jes] [Armin Van Buuren Remix]
Cerf, Mitiska & Jaren - Beggin' You [Armin Van Buuren Remix]
Cerf, Mitiska & Jaren - You Never Said [Dash Berlin Remix]
Chico Del Mar & DJ Base - Carribean Queen [Jay Frogs Sun Mix]
Ciara - Love, Sex & Magic [Ft. Justin Timberlake] [Jason Nevins Sex Club Radio Mix]
Clubhunter - Rain Again
Coast 2 Coast - Home [Ft. Discovery]
Cold Blue & Del Mar - 11 Days [Sebastian Brandt Rework]
Cosmic Gate - Body Of Conflict [Ft. Denise Rivera]
Daniel Kandi - Venice Beach
Dash Berlin - Waiting [Ft. Emma Hewitt]
Dave202 - Louvre
Deadmau5 - Faxing Berlin
Depeche Mode - Wrong [Thin White Duke Remix]
DJ Ensamble Pres. Trancing Queen - The Winner Takes It All
DJ German & Friends - Ich War Noch Niemals In New York [Short Version]
DJ Shah - Who Will Find Me [Ft. Adrina Thorpe]
Empire Of The Sun - Walking On A Dream [Kaskade Remix]
Envio - For You [The Blizzard Remix]
Espen Gulbrandsen Vs. DJ Julian Vincent - Perfect Sky [Ft. Maria Nayler]
Evbointh - One Wish [Daniel Kandi & Mark Andrez Remix]
Fabio XB & Ronnie Play & Gabriel Cage - Inside Of You [Cosmic Gate Remix]
Fawni - Serious [Radio Mix]
Fiesta Brazil - Lambada
First State - Brave [Ft. Sarah Howells]
Flo Rida - Right Round [Benny Benassi Remix Edit]
Gaia - 4 Elements
Gaia - Tuvan [Gareth Emery Remix]
Ian Betts - False Gods
Inertia - The System
Ingsha - Montego Bay
Jackson 5 - Dancing Machine [Polow Remix]
Jan Johnston - Calling Your Name [Thrillseekers Remix]
Jochen Miller - Brace Yourself [Extended Mix]
Juan Serrano - Bocaccio [Ft. Miguel Lara] [Dr. Kucho Remix]
Julian Jeweil - Air Conditionne
Julian Vincent - Here For Me [Ft. Cathy Burton] [Mark Otten Re-Dub]
Julie Thompson - What Will I Do
Kai Tracid - Your Own Reality [Vocal Mix]
Keri Hilson - Knock You Down [Ft. Kanye West & Ne-Yo] [Bimbo Jones Radio Remix]
Kismet - Vita
Kyau Vs. Albert - Velvet Morning [Mirco De Govia Remix]
Lange & Andy Moor - Stadium Four
Lost Witness Vs. Sassot - Whatever [Aly & Fila Remix]
Luca Ricci & Ventinesimo Secolo - Tribute To San Francesco D' Assisi [Christos Fourkis Remix]
M6 - Paradise Lost [Original Mix]
Mac & Mac Vs. Julie Thompson - Only Solid Session Hurts [Cosmos Mashup]
Madhouse - Like A Prayer [Radio Edit]
Marc Et Claude - Free Spirit [Ft. Maria Nayle] [Marc Van Linden Remix]
Marcus Schossow With Andy Duguid â€“ Light [Ft. Emma Hewitt]
Mariah Carey - Obsessed [Seamus Haji Club Mix]
Mario Lopez - Another World [Vocal Edit]
Mark Simmons Vs. John De Mark - The Way
Markus Schulz - Do You Dream [Uplifting Mix]
Martin Solveig - One 2, 3 four [B.C Fm Version]
Michael Jackson - Stranger In Moscow [Jerome Isma-Ae Remix]
MIKE - Sunrise At Palamos 2009 [Gareth Emery Remix]
Mike Shiver - On The Surface [Alex Morph Remix]
Mirco De Govia - Epic Monolith [Original Mix]
Myon & Shane 54 - Vampire [Ft. Carrie Skipper] [Club Mix]
Nic Chagall - What You Need [Hard Dub Reedit]
Onova - Platitude [Original Mix]
Paul Van Dyk - For An Angel [E-Work Club Mix]
Plumb - Hang On [Digital Dog Radio Edit]
Queensberry - Too Young [M.A.T. Catwalk Mix]
RAM - Ramsterdam [Jorn  Van Deynhoven Remix]
Rank  1 - Breathing [Club Mix]
Richard Grey - One More Time [Denis The Menace Remix]
Roger Shah & Signum - Healesville Sanctuary [Roger Shah Mix]
Roland Klinkenberg - Mexico Can Wait [Ft. DJ Remy] [Original Mix]
Scotty - The Black Pearl [Night Remix]
Sean Kingston - Fire Burning [Dave Aude Radio Remix]
Sean Tyas - I Remember Now [Sied Van Riel Remix]
Sour Grapes - Stay For Now [Sandro Monte Remix]
Sunlounger - Another Day On The Terrace [Intro Club Mix]
Sunlounger - Change Your Mind [Ft. Kyler England] [Myon & Shane 54 Remix]
Sylver - Turn The Tide [Radio Edit]
The Doppler Effect - Beauty Hides In The Deep [John O'Callaghan Remix]
The Good Guys - Triangle [Original Mix]
The Killers - Spaceman [Tiesto Remix]
The Thrillseekers - The Last Time [Ft. Fisher] [Original Mix]
TheWeebl - Epixture
Tiesto - I Will Be Here [Ft. Sneaky Sound System]
Tiesto - Louder Than Boom [Extended Mix]
Tommy Vee & Mauro Ferrucci - Stay 09 [Ft. Ce Ce Rogers] [Thomas Gold Vocal]

Enjoy, SvC