 http://enigmat.webhop.net
.
Join My Facebook Page for latest updates  --
.
.
Aber - Start Line (Starter Edit) (-96kbs- Cut From DJ Marcus Set)-enTc.mp3
Abstract Vision & Elite Electronic - Sophia (Cut From Powers Set)-enTc.mp3
Adam Antine & Tenthu - When You Stand Upon Me (Proff Remix) (Cut From Schossow Set)-enTc.mp3
Adrian Auburn - No Break (Cut From Jules Set) (Â«â€¢Â»)-enTc.mp3
Afternova - Serenity (Andy Blueman Remix) (Cut From A&F Set)-enTc.mp3
Air T & Satelite - Azure Coast (Ivan Litus Remix) (Cut From Solarstone Set)-enTc.mp3
Ajello - Hot July (Marius Version) (Cut From Nobody Hero Set)-enTc.mp3
Alaa & Kristoffer Ljungberg - Soleil (Original Mix) (Cut From Airwave Set)-enTc.mp3
Alessandro Diga - Trouble Ahead (Original Mix) (Cut From Athan Set)-enTc.mp3
Amobea Assasin - Rollecoaster (KOS Remix) (Cut From Greg Set)-enTc.mp3
Andrea Oliva - Goa (Original Mix) (Cut From Dinka Set)-enTc.mp3
Andrey Potyomkin - For Your Soul (Original Mix) (Cut From Hawker Set)-enTc.mp3
Angelo Petrucci - Thumper (Original Mix) (Set Rip)-enTc.mp3
Anna Wave - Walking On The Sky (Prod. Magnetic Brothers) (Cut From East Sun Set) (Â«â€¢Â»)-enTc.mp3
Arion Grey & Deep Shepherd - High Thoughts (LoQuai Remix) (Cut From Athan Set)-enTc.mp3
Artcrime - Like This (Dub Mix) (Cut From Flash Set)-enTc.mp3
Arthur Pozdny - Hope (Cut From Kira Set)-enTc.mp3
Arty Pres. Alpha 9 - Hope (TATW 310 Rip)-enTc.mp3
Astronivo - My World (Cut From Jacbri Set)-enTc.mp3
Atrium Sun - Breath Of Heaven (Cut From Monnier Set)-enTc.mp3
Audien - Transition (Original Mix) (Cut From Holland CD)-enTc.mp3
Bastian Salbart - Alone in the Moon (Cut From Schossow Set)-enTc.mp3
Bastian Salbart - The More, The Better (Cut From Ronde Set)-enTc.mp3
Beat Syndrome - Space Exploration (Original Mix) (-96kbs- Cut From DJ Marcus Set)-enTc.mp3
Becari - Ljobovilja (Pacco & Rudy B Remix) (Cut From Jacbri Set)-enTc.mp3
Beltek - Playmaker (Original Mix) (Cut From Dinka Set)-enTc.mp3
Blackfeel Wite - Amnesia (J-Soul Remix) (Cut From Darey Set)-enTc.mp3
Bp Zulauf - Petite Mouche (Dj Tim & Andi Vasilos Remix) (Cut From Da Syk Set)-enTc.mp3
Brisker & Magitman - Butterfly (Weekend Heroes Remix) (Cut From Darey Set)-enTc.mp3
Bruni Bergeron - Theme From Nothingless (TrancEye Remix) (Cut From Space Garden Set)-enTc.mp3
BT feat. JES - The Light in Things (Airwave Remix) (Cut From Airwave Set)-enTc.mp3
Calvertron - Oh Ley (Original Mix) (Cut From Kane Set)-enTc.mp3
Caninesounds - Twizzle (-Short- Cut From Halliwell Set)-enTc.mp3
Carlos Fox - Just Remember Again (Cut From Kira Set)-enTc.mp3
Carlos Fox - My Medicine (Cut From Kira Set)-enTc.mp3
Chris Reece & Dinka - Autumn Leaves (Michael Cassette Remix) (Cut From Dinka Set)-enTc.mp3
Christian R - Deserts (Original Mix) (Cut From Athan Set)-enTc.mp3
Christos Fourkis - Bird Of Paradise (Cut From Fourkis Set) (Â«â€¢Â»)-enTc.mp3
Christos Fourkis - Give Me Love (Set Rip) (Â«â€¢Â»)-enTc.mp3
Christos Fourkis - In The Air (Original Mix) (Cut From Athan Set) (Â«â€¢Â»)-enTc.mp3
Christos Fourkis - Touch Of Soul (Cut From Fourkis Set)-enTc.mp3
Cirez D vs Black Raw - Rock da Haus On Off (Reaky Mashup) (Cut From Sherry Set) (Â«â€¢Â»)-enTc.mp3
Claudia Cazacu Feat. Audrey Gallagher vs. Cressida â€˜Falling Onyric @ Two-O-Ten (Arnesto & Wright Mashup) (Rip)-enTc.mp3
Cloudiver - Summer Nights (Cut From Yaz Set)-enTc.mp3
Clubzound - Aztek Nights (Clubzound Mix) (Cut From Airwave Set)-enTc.mp3
Codar - Focus (Original Mix) (Cut From Blusoul Set)-enTc.mp3
Cold Blue - Orient Sun (TATW 310 Rip)-enTc.mp3
Combo - Tungsteno (Alex Kenji Remix) (-96kbs- Cut From Mack Set)-enTc.mp3
Dahies Oh - Green Heart (Original Mix) (Cut From DeSaid Set)-enTc.mp3
Dan Syndrome - Refresh (Cut From Okanas Set)-enTc.mp3
Daniel Gregory - Twister (Original Mix) (Cut From Flash Set)-enTc.mp3
Daniel Kandi & Martijn Stegerhoek- As One (Original Mix) (Cut From Holland CD)-enTc.mp3
Daniel Portman - For Your Soul (Original Mix) (Cut From Dinka Set)-enTc.mp3
Danny Tenaglia - Dibiza (Solee Remix) (Cut From Greg Set)-enTc.mp3
Darko Pres. strange Worlds - Danote (Cut From Aruba Set)-enTc.mp3
Dave Stephens - Boundaries (Cut From Tyas Set)-enTc.mp3
De Ponti & Jasmin vs Connell - Hypnobomb (F1DO vs Biohazard Mashup) (Cut From Coutts Set)-enTc.mp3
Deep Active Sound Feat. Cotry - Sunrise (Christos Fourkis Remix) (Set Rip)-enTc.mp3
Deep Sound - Air (Cut From East Sun Set) (Â«â€¢Â»)-enTc.mp3
Deepgroove & Jamie Anderson - Invaders (Original Mix) (Cut From Kane Set)-enTc.mp3
Dennis Pedersen - 4am (Original Mix) (Cut From Pedersen Set)-enTc.mp3
Dezarate & Michel Manzano - Soul Is In The Air (Original Mix) (Set Rip)-enTc.mp3
Dezarate & Michel Manzano - The Room (Original Mix) (Set Rip) (Â«â€¢Â»)-enTc.mp3
Dicebox - Latin Girl (Original Mix) (Cut From Blusoul Set)-enTc.mp3
Dick Ray - Olle Bien (MNL Remix 1) (Cut From Greg Set)-enTc.mp3
Dinka - In Command (Original Mix) (Cut From Dinka Set)-enTc.mp3
DJ Ceratti & Jaydas - Expanded (Original Mix) (-96kbs- Cut From DJ Marcus Set)-enTc.mp3
DJ Ceratti & Jaydas - Still Perturbed (Original Mix) (-96kbs- Cut From DJ Marcus Set)-enTc.mp3
DJ Eco - People (Matthew Nagle Remix) (Cut From Schossow Set)-enTc.mp3
DJ Gard - Fantasy (Aeden Remix) (Cut From Space Garden Set)-enTc.mp3
DJ Observer & Daniel Heatcliff - Cowabunga (Cut From O'Neil Set) (Â«â€¢Â»)-enTc.mp3
DJ Preach - Obscurantis (Eric Sneo Remix) (Cut From Fei Set) (Â«â€¢Â»)-enTc.mp3
Dom Kane - Desire (Original Mix) (Set Rip)-enTc.mp3
Dom Kane - Exposed (Original Mix) (Cut From Kane Set)-enTc.mp3
Douglas Howarth - Would You Make Toast With Me (Retroid Dub Mix) (Cut From Hoppe Set)-enTc.mp3
Dub Brothers - The End Of Life (Luciano Lima Remix) (Cut From Zola Set)-enTc.mp3
Earthtone - As One (Terry Lee Brown Jr. Remix) (Cut From Aruba Set)-enTc.mp3
EDU Pres. 5tranger - Far Away (Cut From Saint-Jules Set)-enTc.mp3
Einar K - Schiphol (Cut From Jong Set)-enTc.mp3
Elite Force - Jack The Joint (Introspective Mix) (Cut From Kane Set)-enTc.mp3
Ernest Luminor - Legacy (Pako & Frederick Remix) (Cut From Kira Set)-enTc.mp3
Estiva - Dalmatia (Edit) (Cut From Will Holland CD)-enTc.mp3
Evren Ulusoy & Sezer Uysal - Turkish Mood (Klever Remix) (Cut From Monnier Set)-enTc.mp3
Fabien Kamp - Electric Room (Original Mix) (Cut From Blusoul Set)-enTc.mp3
Faisal Baig - Gnostica (Original Mix) (Cut From Jacbri Set)-enTc.mp3
Ferry Tayle & Static Blue - L'Acrobat (Ferry Tayle 'E-Motion Mix) (Set Rip)-enTc.mp3
Fleeticer - Across The Globe (Braincreator Remix) (-Short- Cut From Shadows Set) (Â«â€¢Â»)-enTc.mp3
Francesco Farfa - Founding Magdalene (1st Inspiration Mix) (Cut From Jacbri Set)-enTc.mp3
Fred Baker vs Simon Patterson - Luminar Smack (Cut From Jules Set) (Â«â€¢Â»)-enTc.mp3
Freejak - Telling Me Someday (James Herkes Update) (-Sample- Cut From Jules Set)-enTc.mp3
Freza & Dj Flash - Air Trip (Synthetika Melodic Remix -w- Cruel Summer Acepella) (Set Rip)-enTc.mp3
Fridge - Angel (Priority Oneâ€™s 2010 Upbeat Remix) (Cut From Wright Set)-enTc.mp3
Future Disciple - River Dance (Cut From Yaz Set)-enTc.mp3
Future Disciple - The PR (Cut From Jules Set)-enTc.mp3
Galan - Space Dust (Magnetic Brothers Remix) (Cut From SLanG Set)-enTc.mp3
Gavyn Mytchell - Panzer (Ruben de Ronde Remix) (Cut From Schossow Set)-enTc.mp3
George Cochrane - My Synthesizer Won't Behave (Original Mix) (Cut From Aruba Set)-enTc.mp3
George F. Zimmer - Civilization (Dinka Remix) (Cut From Dinka Set)-enTc.mp3
George F. Zimmer - Departure (Original Mix) (Cut From Dinka Set)-enTc.mp3
Gordon Coutts - Back To Tekk (Gordon Coutts Tech Mix) (Set Rip)-enTc.mp3
Groovematic - Xpand (Cut From Python Set)-enTc.mp3
G-Sky & Vosch - Casyopea (Air-T Remix) (Cut From Shadows Set) (Â«â€¢Â»)-enTc.mp3
Guido Sava - 7am (Original Mix) (Cut From Zola Set)-enTc.mp3
Guy Mearns - Obese (Cut From Sherry Set)-enTc.mp3
Hamdi Ryder - Entrance Trompittist (Ramiro Bernabela Remix) (Cut From SLanG Set)-enTc.mp3
Harri Agnel - Aqua Life (Christos Fourkis Remix) (Cut From Fourkis Set) (Â«â€¢Â»)-enTc.mp3
Hypnotic Duo - Memory Lights (Cut From Kira Set)-enTc.mp3
Hypnotic Duo - Over And Over (Cut From Kira Set)-enTc.mp3
Hypnotic Duo - Sound of Glory (ZB Remix) (Cut From Athan Set)-enTc.mp3
Hypnotic Duo & The Kps - For How Long (Cut From Monnier Set)-enTc.mp3
Ian Buff & Franky Faith - A New Day (Ian Buff Uplifting Mix) (Set Rip)-enTc.mp3
Ice Upon Fire - Mind Stories (Original Mix) (Cut From Space Garden Set)-enTc.mp3
Icone - Cosmos (Fei Fei Remix) (Cut From Jules Set) (Â«â€¢Â»)-enTc.mp3
Introspective - Devil Theory (Original Mix) (Cut From Flash Set)-enTc.mp3
Ismael Sanchez & Stevan Chaves Feat. Lisa Rose - What Do You Feel (Javi Reina & Alex Guerrero Remix) (Set Rip)-enTc.mp3
Ivan Enot - One Night in Kathmandu (Cut From Nobody Hero Set)-enTc.mp3
Ivan Nikusev & Kay D - Circulating Birds (Circulating Birds) (Cut From Athan Set) (Â«â€¢Â»)-enTc.mp3
Ivan Nikusev & Kay D - Circulating Birds (Krisztian & Robert K Remix) (Cut From Athan Set)-enTc.mp3
Jaap Ligthart - Alive Cat (Yura Popov Mix) (-96kbs- Cut From DJ Marcus Set)-enTc.mp3
Jack Stereo - Jolly German (Lm Remix) (Cut From Monnier Set)-enTc.mp3
Jairus Miller - Close Encounter (Original Mix) (Cut From Hawker Set)-enTc.mp3
Jairus Miller - Peekaboo (Original Mix) (Cut From Hawker Set)-enTc.mp3
Jairus Miller - Silicon Sea (Original Mix) (Cut From Hawker Set)-enTc.mp3
Jason Kinetic - Sidechained Melody (Digital Horizon Mix) (Set Rip)-enTc.mp3
Jasper Jinx - Dondersteen (Cut From Airwave Set)-enTc.mp3
Jaytech - Pyramid (Dinka Special Melo Mix) (Cut From Dinka Set)-enTc.mp3
Jimmy Galle - Eleventh (Planisphere Remix) (Cut From Airwave Set)-enTc.mp3
John '00' Fleming & Digital Blonde - Soulmate (00.db Mix) (Cut From Ascherl Set)-enTc.mp3
John Askew - F@cking Caps Lock (Original Mix) (Cut From Tyas Set)-enTc.mp3
John Askew - Nail Gun (Greg Downey Remix) (Cut From Downey Set)-enTc.mp3
Johnny Yono - UNTITLED (-96kbs- Cut From Flyers Set)-enTc.mp3
Jonas Stenberg & Dave Schiemann - The Drop (Mark Sherry's Outburst Remix) (Set Rip) (Â«â€¢Â»)-enTc.mp3
Jonno Brien - Here Comes The Drums (NEW Cut From O'Neil Set) (Â«â€¢Â»)-enTc.mp3
Jorge Martin S - Heat (Cut From Jules Set)-enTc.mp3
Josel - Synasthesia (Jacco@work Remix) (-96kbs- Cut From DJ Marcus Set)-enTc.mp3
Joy Marquez Feat. Ekaterina - Magical Star (Ramses Jair Remix) (Cut From Darey Set)-enTc.mp3
Julius Beat Feat. Eddy Karmona - Fly With Me (Andy Day Remix) (Cut From 2 Damn Set)-enTc.mp3
Junior Lopez & Martin Huergo - Paz Espada (Original Mix) (Cut From Greg Set)-enTc.mp3
Juventa - UNTITLED (-96kbs- Set Rip)-enTc.mp3
JVA - Autobahn (PM Mix) (Cut From Bolier Set)-enTc.mp3
Kaanturker - Fuckin Hate Cops (Christos Fourkis Remix) (Set Rip)-enTc.mp3
Kaeno & Denzo - Cabin Pressure (Indecent Noise Spark Mix) (Cut From Buff Set)-enTc.mp3
Kahraman - Memat (Federico Epis Remix) (Cut From Kira Set)-enTc.mp3
Karybde & Scylla - Reflexions Of Lights (Trance Arts Remix) (Set Rip)-enTc.mp3
Kay-D - Behind The Dune (Cut From Denko Set)-enTc.mp3
Kayden - Black Emotion (Original Mix) (Cut From Pedersen Set)-enTc.mp3
Kazell - Chatter (Dubfunk Sledgehammer Remix) (Cut From Da Syk Set)-enTc.mp3
Klauss Goulart - Misty (Dub Mix) (Cut From Solarstone Set)-enTc.mp3
Kollektiv Turnstrasse - Dead Room (Cut From Okanas Set)-enTc.mp3
KOOQLA - Mute (Atlantis Ocean Remix) (Cut From Southey Set)-enTc.mp3
Lange - Under Pressure (Original Mix) (-Short- Cut From Corsten Set)-enTc.mp3
Le Ron And Yves Eaux - Is It L8 (Cut From Coda Set)-enTc.mp3
Leon Bolier - Shimamoto (Aly & Fila Remix) (Set Rip)-enTc.mp3
Leonid Rudenko - Somebody (Cut From Jules Set)-enTc.mp3
Liam Melly - Automator (Cut From Downey Set)-enTc.mp3
Little Boots - Stuck On Repeat (Ali Wilson Remix) (Cut From Jules Set)-enTc.mp3
Lolo - Myla's Dance (Cut From Airwave Set)-enTc.mp3
Lorenz Rhode - Like A Player (Shazam Remix) (-Short- Cut From Nobody Hero Set)-enTc.mp3
Lukas Greenberg - The Flash (Da Funk's Lightning Strike Mix) (Cut From Aruba Set)-enTc.mp3
Mafia Mike - Love Song (Moonbeam Remix) (-96kbs- Cut From Garrett S Set)-enTc.mp3
Magnetic Brothers - Tunnel (Pacco & Rudy B Remix) (Cut From SLanG Set) (Â«â€¢Â»)-enTc.mp3
Mantelis - I Love Trance (Original Mix) (Cut From Kaneda Set)-enTc.mp3
Mantelis - Never Forget (Original Mix) (Cut From Kaneda Set)-enTc.mp3
Marcel Woods - Inside Me (RAM & Gordon Coutts Remix) (Cut From Coutts Set)-enTc.mp3
Marcelo Vasami - Switch Blade (Masque Remix) (Cut From Python Set)-enTc.mp3
Mark Burton - Viper (Cut From Downey Set)-enTc.mp3
Mark Sherry vs Dr Willis - Sesmic (Original Mix) (Set Rip) (Â«â€¢Â»)-enTc.mp3
Mars Need Lovers - Dedicated (Cut From Python Set)-enTc.mp3
Masque - Elefantes (Swing Herd Edit) (Cut From SLanG Set)-enTc.mp3
Matt Cerf vs Eric Meza Feat. Jaren - With Me (Lexwood Remix) (Cut From Feel Set)-enTc.mp3
Matt Cerf vs Eric Meza Feat. Jaren - With Me (Lexwood Remix) (Cut From Yaz Set)-enTc.mp3
Matt Masters - Deep Or What (Milton Jackson Remix) (Cut From Aruba Set)-enTc.mp3
Matteo Monero - Tranquillity (Matteo Monero Remix) (Cut From Zola Set)-enTc.mp3
Matthew Dunne - Catapault (Cut From Coutts Set)-enTc.mp3
Maxplay - Reminiscence (Norberto Fornerino Remix) (Cut From Athan Set)-enTc.mp3
Memento & Steve Nomac - Rumours (Original Mix) (Cut From Bennett Set) (Â«â€¢Â»)-enTc.mp3
Michael Dow - Red Shift (Cut From Solarstone Set)-enTc.mp3
Michael Poliak - Palava (Nicholas Bennison Remix) (Cut From SevenWays Set)-enTc.mp3
Miikka Leinonen - Kingdom Fall (Rozza Remix) (Cut From Yaz Set)-enTc.mp3
Mike Harrington - Night Kissed (Mihai Christian Mix) (-96kbs- Cut From Garrett S Set)-enTc.mp3
Mikel Curcio Feat. Daniella - In Your Head (Noir Remix) (Cut From Greg Set)-enTc.mp3
Montanas & Roland Clark - Music Talking (DONS & DBN Remix) (Cut From Jules Set)-enTc.mp3
Motionchild & Will Holland Feat. Tiff Lacey - Arctic Kiss (Andy Duguid Remix) (Cut From Holland CD)-enTc.mp3
MW - Big Cause (Cut From Jules Set) (Â«â€¢Â»)-enTc.mp3
Nash & Pepper - Aftersun (Mike Foyle Full Moon Remix) (Cut From Foyle Set)-enTc.mp3
Nash & Pepper - Killed The Love (Airwave Remix) (Set Rip)-enTc.mp3
Neelix - Adaption (Original Mix) (Cut From Revel Set)-enTc.mp3
Neelix - Chainsaw (Vaishiyas Remix) (Cut From Revel Set)-enTc.mp3
Nicholas Bennison - Spirit Chamber (Reaky Remix) (Cut From Ascherl Set)-enTc.mp3
Nick Chacona - Autumn Pass (Cut From Nobody Hero Set)-enTc.mp3
Niko Fantin - Zoofisticated (Soliquid Remix) (Cut From Python Set)-enTc.mp3
Nikos Diamantopoulos Feat. Elena - Open Your Eyes (Original Mix) (Cut From Denko Set)-enTc.mp3
Nino Anthony - Helena Hotfingers (-96kbs- Cut From Garrett S Set)-enTc.mp3
Nitrous Oxide Feat. Aneym - Far Away (TATW 310 Rip)-enTc.mp3
Nivek Tsoy - Let The Fun Begin (Cut From Aruba Set)-enTc.mp3
Oen Bearen & TrancEye - Masuo (Cut From Powers Set)-enTc.mp3
Ogi Gee Cash - Tokyo (Erick Ramirez Remix) (Cut From Jacbri Set)-enTc.mp3
Oliver Smith - Sunday (TATW 310 Rip)-enTc.mp3
Orange Lights - Life Is Still Beautiful (Alan Braxe Main Mix) (-Short- -BBC- Cut From Jules Set)-enTc.mp3
Outrageous Okona's - Danny, Not Simon (Set Rip)-enTc.mp3
Overseer - Doomsday (Dj Hyper Remix) (Cut From Flash Set)-enTc.mp3
Pablo Gael - Libelula (Cut From Airwave Set)-enTc.mp3
Paco & Rudy B - Marathon (Cut From Monnier Set)-enTc.mp3
Paradox 3000 - Punked Up Funk (Cut From Flash Set)-enTc.mp3
Paul Keeley Feat. Natalie Peris - Disco Belle (Peter Martin Remix) (Cut From Airwave Set)-enTc.mp3
Paul Sparkes & Edgar Duijff - Response (Sven Hauck Remix) (Cut From Monnier Set)-enTc.mp3
Paul Tarrant - Sunset Serenade (JPL Remix) (Cut From Ronde Set)-enTc.mp3
Paul Tarrant - Sunset Serenade (Original Mix) (Cut From Holland CD)-enTc.mp3
Paul Vinitsky Feat. Amy - Water Dance (Club Mix) (Cut From Feel Set)-enTc.mp3
Paul Webster - Corruption (Mac & Taylor Remix) (Cut From Jules Set) (Â«â€¢Â»)-enTc.mp3
Pete Silver - Corona (Original Mix) (Cut From Wright Set)-enTc.mp3
Probspot - Blows My Mind (J-Soul Remix) (Cut From Sherry Set)-enTc.mp3
Product.01 Feat. Rochelle Vincente - Fix Me (Broken Robot Mix) (Cut From Flash Set)-enTc.mp3
Rank 1 - Airwave (Ciaron Fox Bootleg) (Cut From Wright Set)-enTc.mp3
Redloft - Second Sunrise (Santiago Deep Mix) (-96kbs- Cut From DJ Marcus Set)-enTc.mp3
Retroid - Supernatural (Karton Remix) (Cut From Retroid Set)-enTc.mp3
Richard Durand - Tiger's Apology (Original Mix) (Cut From Corsten Set)-enTc.mp3
Roddy Reynaert - Thalys (Nick Stoynoff Remix) (Cut From Monnier Set)-enTc.mp3
Roger Shah Pres. Savannah - Darling Harbour (Fast Distance Remix) (Set Rip)-enTc.mp3
Roger Shah presents Savannah - Darling Harbour (Electribe Remix) (Cut From Schwan Set)-enTc.mp3
Roland M. Dill - Taurine On Sunday (Egbert Remix) (Cut From 2 Damn Set)-enTc.mp3
Ryan Mullin - Jks Call (Colours Mix) (Cut From Coda Set)-enTc.mp3
Sam Walkerstone feat. Francis Matthew - Then I Remember (Laanga Remix) (Cut From Tyas Set)-enTc.mp3
Sand & Sense - Together (The Flyers & Mike Sonar's Original Mix) (Cut From Holland CD)-enTc.mp3
Sander van Doorn - Renegade (Mike Emvee Remix) (Cut From Sherry Set)-enTc.mp3
Santiago Deep - Prototype (Original Mix) (-96kbs- Cut From DJ Marcus Set)-enTc.mp3
Santiago Deep - Sincronizacion Continua (Original Mix) (-96kbs- Cut From DJ Marcus Set)-enTc.mp3
Santiago Garcia Feat. Damian - Cisne (Francesco Pico Remix) (Cut From Monnier Set)-enTc.mp3
Santogold - Say A-Ha (Tom Neville Remix) (Cut From Jules Set)-enTc.mp3
Sasha Le Monnier - Inspired By Those (Mario & Eric J Remix) (Cut From Monnier Set)-enTc.mp3
Serge Devant - Wanderer (Remix) (Cut From Darey Set)-enTc.mp3
Sergei Skuroff & Lovestoned vs Planet Funk - Terra Icognito Chase The Sun (Anton Sonin Bootleg) (Cut From Schossow Set)-enTc.mp3
S-Groove - Feel Your Soul (Randall Jones Remix) (-96kbs- Cut From Mack Set)-enTc.mp3
Shabu Vibes - Night Love (Aydan Remix) (Cut From Athan Set)-enTc.mp3
Shingo Nakamura - Alice In Wonderland (Kobana & Mario Hatchet Remix) (Cut From Jacob Set)-enTc.mp3
Silence O Phobia - Dark Storm (Diego Mongelos Dark Remix) (Cut From Denko Set)-enTc.mp3
Simon Firth - Strawberries (Trim The Fat Remix) (Cut From Kira Set)-enTc.mp3
Simon Patterson - Thump (Immersiveâ€™s Lifter Mix) (Cut From Wright Set)-enTc.mp3
Simon Patterson vs Coldplay - Missing Scientist (Mark Sherry Mashup) (Set Rip) (Â«â€¢Â»)-enTc.mp3
Sindre Eide - Two Against The World (Original Mix) (Cut From Holland CD)-enTc.mp3
Soliquid - Marghuerite (-96kbs- Cut From Garrett S Set)-enTc.mp3
Something Good - La Biankini (Terry Da Libra Remix) (Cut From Schossow Set)-enTc.mp3
Soulfinder - Forte (Nikitin & Semikashev Remix) (Cut From Aruba Set)-enTc.mp3
Soulfinder - Fundament Movement (Original Mix) (Cut From Hawker Set)-enTc.mp3
Soulwax - Kids (DJ Mog Remix) (Cut From Jules Set) (Â«â€¢Â»)-enTc.mp3
SoundLift - Nakthi (Ferry Tayle & Stephan R Pres. Mirage Remix) (NEW Set Rip)-enTc.mp3
Soundprank - Segway (Cut From Kira Set)-enTc.mp3
Stonevalley - Winter (Original Mix) (Cut From Holland CD)-enTc.mp3
Syp - Ocean Bottom (Jerome Montes Mix) (-96kbs- Cut From DJ Marcus Set)-enTc.mp3
Teana & Tiida - Snow Flakes (Cut From SLanG Set)-enTc.mp3
Teana & Tiida - Tiida (Cut From East Sun Set) (Â«â€¢Â»)-enTc.mp3
Temple One & Mark Andrez - Gran Canaria (Original Mix) (Cut From Holland CD)-enTc.mp3
Tenthu - Play Me (Sergey Shemet Remix) (Cut From Aurosonic Set)-enTc.mp3
The Flyers & Mike Sonar - Reveal (Original Mix) (Cut From Holland CD)-enTc.mp3
The Flyers & Mike Sonar - Signalica (-96kbs- Set Rip)-enTc.mp3
The French Connection - Booth (Original Mix) (Cut From Airwave Set)-enTc.mp3
Three Drives - Carerra 2 (Gary Proud Remix) (Cut From Downey Set)-enTc.mp3
Tiga - Mind Dimension (Cut From Jules Set)-enTc.mp3
Tigran Oganezov - Cryisexe (Cut From Van Bell Set)-enTc.mp3
Tim Andreson - Gimmay (Nick Hook Remix) (-96kbs- Cut From Mack Set)-enTc.mp3
Timo Garcia Feat. Amber Jolene - Magic Roundabout (Cut From Darey Set)-enTc.mp3
Tonkproject - Portclub (Cut From Python Set)-enTc.mp3
Tony Deep Fish - 7 Minutes After Midnight (Chris Reece Remix) (Cut From Dinka Set)-enTc.mp3
Too Many Artists - Stability On Fire (Reaky Mashup) (Cut From Sherry Set)-enTc.mp3
Toomy Disco - Back From Cosmos (ODahl's Cosmic Remix) (Cut From Nobody Hero Set)-enTc.mp3
Topspin & Dmit Kitz - Froove Groove (Original Mix) (Cut From Darey Set)-enTc.mp3
TrancEye - Baltic Waves (Cut From Powers Set)-enTc.mp3
Tray Swiss - Left Legged Robot (Original Mix) (Cut From Greg Set)-enTc.mp3
Trim The Fat - Vodoo Baby (Original Mix) (Cut From Hawker Set)-enTc.mp3
Tritonal - Utopia (Warm Up Mix) (Cut From Feel Set)-enTc.mp3
Tylor Leigh - Space 42 (Cut From Downey Set) (Â«â€¢Â»)-enTc.mp3
Type 41 - Mystik (POL Remix) (Set Rip) (Â«â€¢Â»)-enTc.mp3
Ulrich Van Bell & BelVisi - Back on Time (Rush Mix) (Set Rip)-enTc.mp3
UNKNOWN - Infinity (Neo Kokkonen Remix) (Cut From Ascherl Set) (Â«â€¢Â»)-enTc.mp3
UNKNOWN - Leaning & Swerving (Cut From Jules Set)-enTc.mp3
UNKNOWN - UNTITLED (Den Rize & Mark Andrez Remix) (Cut From Shadows Set) (Â«â€¢Â»)-enTc.mp3
Van Dresen & Thrice - Subnative (Original Mix) (Cut From Saint-Jules Set)-enTc.mp3
Vast Vision - Lake of Moons (Original Mix) (Cut From A&F Set)-enTc.mp3
Vibetech - Back To Infinity (Sandji's 'Nostalgia' Mix) (Cut From SLanG Set)-enTc.mp3
Way Out West - I Think I'm In Love (Stonebridge Remix) (Cut From Solarstone Set)-enTc.mp3
Xaric - Sunday Morning (Original Mix) (Cut From Athan Set)-enTc.mp3
Xtigma - Loophole (Cut From Sherry Set)-enTc.mp3
Yura Popov - Return To Mars (Original Mix) (Cut From Python Set)-enTc.mp3
Yves Deruyter - Infinity (Steven Lloyd Remix) (Cut From Airwave Set)-enTc.mp3
