DJ King Pigeon presents \"Eurotrash or Eurotreasure?\" DJ set 32: From Midnight to 3:30 AM, an exploration of the European (and otherwise) pop and dance music scene representing a spectrum of countries, cultures, decades, and languages.

Calle 13 - Electro Movimiento
Ladyhawke - Magic
HU? (kaasa teeb Kare Kauks) - Miks ainult moni asi on nii hea?
Phenomenal Handclap Band - 15 to 20 (Montee Remix) (for the Maribor gang)
Sandra - Secret Land
Alphaville - Jet Set Society
Dizzee Rascal - Dance Wiv Me (feat. Calvin Harris)
Alphabeat - DJ
ZZ Top - Sleeping Bag (King Pigeon Rework)
MARRS - Pump Up the Volume
Mighty 44 - This Love Ain't Goin' On
Darius & Finlay feat. Nicco - Destination
Birgit Oigemeel - Moonduja (Pikk versioon)
Electrotheque - Every 1's a Winner (Electrochocolate Mix) (for Luc)
XXX - Sexi Ves
Timbaland - Morning After Dark
Tricky Disco - Tricky Disco (Original Mix)
Uffie - MCs Can Kiss
Undercover - Baker Street (Extended Mix) (for Emma & Dexter)
Justine Juliette Feat. Zlatko - Hip Hop
Thalia - Amor a la Mexicana (Cuca's Fiesta Edit)
Sneaky Sound System - I Love It
NiCe7 - Elisa (Pirupa Remix)
Tom Pulse - Cuando (Floresca El Chuno) Reloaded (Sunshine Club Mix)
Beatbullyz - Skillz (Dave Silcox Refix)
Vitalic - Poison Lips (thanks, Florian!)
Bijelo dugme karma - Hajdemo u planine  (Remix) (for the Friday night DJs at Club Saloon, Zagreb)
Dream Frequency - Feel So Real (Frenzy Remix)
Supershake-Gonna Make You Sweat (Everybody Dance Now) (Alex Twister 2010 extended mix)
Taisia Povaliy - Gry (dedicated to the Kiev gang, January 2010)
Dennis Ferrer - Hey Hey (Attention Vocal Mix)
John Dahlback - Bingo
Kid Massive - Touch Me in the Morning (Avicii's Massive Mix)
Jamie Matrix - Gold Rush (Original Mix)
Faithless - Not Going Home (Eric Prydz Mix)
Memento & Anita Kelsey - Can't Sleep (Original)
Chicane - Hiding All the Stars (Original Club Mix)
69 Danguje - Vasara
Minilogue - Leloo
Mike Candys & Jack Holiday - Push the Feeling On (Christopher S Remix)
MVESM - French Jeans (Dada Life Remix)
Chris & Rob - Superheld (Mein Club Mix)
Dan Balan - Chica Bomb (Radio Edit) (for the Iasi gang)
Alexandra Burke - All Night Long (Cahill Club Mix)
DJ Defkline & Red Polo vs. Dustin Hulton - Cars That Go Boom (Original)
Joachim Garraud - Are U Ready (Laidback Luke Rmx)
Bassboy - Let the Bass Be Louder
Eric Chase - If You Tolerate This (Club Mix)
Jumo Selesao - Zoomer (Club Mix)
666 - Diablo
7-7-0 - Freed from Desire (Original Clubmix)
Maika - Embrasse Moi
Fred Worx - Softly (Rudy Rudy Dog Remix)
Mystique - Don't Stop Me Now (Original Club Mix) (for Cristina)
Dacia - Liikaa Sulta Odotin (Dance Mix)
Hi-Fi/Wanda & Banda - Superstar
Rezarta Shkurta - Matura
Mickie Krause - Duep Duep
Marc de Simon - Rainbow Sky 2010 (Original Mix)
Nick Rowland - Galactica (Original Mix)
Terrorize - Feel the Rhythm
Stunt - Fade Like the Sun (Frisco Mix)
DJ Visage - Rock That Sound
Seka Aleksic - Balkan (Remix)
Dario G - Ring of Fire (Stadium Edit)
