Nederland
Pop
Label: Sony
Damaru - Mi Rowsu (Tuintje in Mijn Hart)
met Jan Smit
The Black Eyed Peas - I Gotta Feeling
Anouk - Three Days in a Row
Lady Gaga - Paparazzi
P!Nk - Funhouse
David Guetta - Sexy Bitch
met Akon
Pixie Lott - Mama Do (Uh Oh, Uh Oh)
Waylon - Wicked Way
The Veronicas - Untouched
Basic Element - Touch You Right Now
met D-Flex
The Pussycat Dolls - Hush Hush
Gregor Salto - Lambada 3000
met Kaoma
Quintino - Heaven
met Mitch Crown
Bertolf - Mr. Light
Silvio Ecomo - Moombah!
met Chuckie
Nikki - How to Break a Heart
Colbie Caillat - Fallin' for You
Armin Van Buuren - Never Say Never
met Jacqueline Govaert
Hansen Tomas - 1000 en 1 Gedachten
Michael Jackson - Billie Jean
Diggy Dex - Slaap Lekker
met Eva De Roovere
Peter Fox - Haus Am See
Cascada - Evacuate the Dancefloor
Pitbull - Hotel Room Service
Nick & Simon - Lippen op de Mijne
U2 - Magnificent
Flo-Rida - Sugar
met Wynter
Agnes - Release Me
Jordin Sparks - Battlefield
Lily Allen - Not Fair
Keri Hilson - Knock You Down
met Kanye West en Ne-Yo
Jason Mraz - Make It Mine
Caro Emerald - Back It Up
Bob Sinclar - Love You No More
met Shabba Ranks
La Roux - Bulletproof
Sono - Keep Control
Gossip - Heavy Cross
Flinke Namen - Als Zij Langsloopt
Kristinia Debarge - Goodbye
Michel Cleis - La Mezcla
met Toto La Momposina


Voor de nieuwste films en muziek ga je naar NLT.Ons-Forum het forum voor de Nederlands Ondertitelde Torrents:

http:/www.nlt.ons-forum.nl


Enjoy The Music!!!!!!!