Swedish chart in Swedish Radio P3 


Yolanda Be Cool & DCUP - We No Speak Americano
Robyn - Dancing On My Own
Agnes & BjÃ¶rn - When You Tell The World You're Mine
Lena - Satellite
Lady GaGa - Alejandro
Stromae - Alors On Danse
Shakira feat. Freshlyground - Waka Waka (This Time For Africa)
Rasmus Seebach - Natteravn
K'naan - Wavin' Flag
Edward Maya & Vika Jigulina - Stereo Love
Sean Banan - Skaka Rumpa
Katy Perry feat. Snoop Dogg - California Gurls
Pink - Funhouse
Train - Hey, Soul Sister
Oskar Linnros - FrÃ¥n Och Med Du
Sarah Dawn Finer - KÃ¤rleksvisan
Travie McCoy feat. Bruno Mars - Billionaire
Lars WinnerbÃ¤ck - FrÃ¥n Kylan In I VÃ¤rmen
B.o.B feat. Hayley Williams
Airplanes - Rebel Rock/Grand Hustle/Atlantic
Lady Antebellum - Need You Now
Lady GaGa feat. BeyoncÃ© - Telephone
Eminem feat. Rihanna - Love The Way You Lie
Lars WinnerbÃ¤ck - En StannfÃ¥gel Ger Sig Av
Swedish House Mafia - One
Taio Cruz - Break Your Heart
Melanie Fiona - Monday Morning
David Guetta feat. Kid Cudi - Memories
Eminem - Not Afraid
Eric Saade - Manboy
Erik Hassle - Standing Where You Left Me
Usher feat. wiil.i.am - OMG
David Guetta & Chris Willis feat. Fergie & LMFAO - Gettin' Over You
Scissor Sisters - Fire With Fire
Kelly Rowland feat. David Guetta - Commander
Johnossi - What's The Point
Owl City - Fireflies
Joshua Radin - I'd Rather Be With You
Lady GaGa - Bad Romance
Darin - Can't Stop Love
Daniel Adams-Ray - Dum Av Dig
Timoteij - Kom
Kato feat. Jon - Turn The Lights Off
Adam Lambert - Whataya Want From Me
Cheryl Cole - Fight For This Love
Lady GaGa - Paparazzi
Enrique Iglesias feat. Nicole Scherzinger - Heartbeat
Rihanna - Te Amo
David Guetta feat. Akon - Sexy Bitch
Ola - Overdrive
Dj Mangoo feat. Deadline - Fanta & RosÃ©
Kylie - All The Lovers
Kent - Skisser FÃ¶r Sommaren
Hoffmaestro - Highway Man
Journey - Don't Stop Believin'
Black Eyed Peas - Meet Me Halfway
Kent - Utan Dina Andetag
Ke$ha - Your Love Is My Drug
Ne-Yo - Beautiful Monster
Tove Styrke - Million Pieces