Sygic.Maps.Europe.2009.iPhone.By.Dahbi.

Cartes Sygic Mobile Maps Europe 2009 pour iPhone.
 
http://thepiratebay.org/torrent/5019075/Sygic.2009.By.Dahbi.v7.71.1.ipa


ALB = Albanie
AND = Andorre
AUT = Autriche
BEL = Belgique
BGR = Bulgarie
BIH = Bosnie-HerzÃ©govine
BLR = BiÃ©lorussie
CHE = Suisse
CZE = RÃ©publique TchÃ¨que
DEU = Allemagne
DNK = Danemark
ESP = Espagne
EST = Estonie
FIN = Finlande
FRA = France
GBR = Royaume-Uni / (Grande-Bretagne)
GIB = Gibraltar
HRV = Croatie
HUN = Hongrie
IRL = Irlande
ITA = Italie
LIE = Liechtenstein
LTU = Lituanie
LUX = Luxembourg
LVA = Lettonie
MCO = Monaco
MDA = Moldavie
MKD = MacÃ©doine, Ex-RÃ©publique Yougoslave
MLT = Malte
MNE = MontÃ©nÃ©gro
NLD = Pays-Bas (Nederland)
NOR = NorvÃ¨ge
POL = Pologne
PRT = Portugal
ROU = Roumanie
SMR = Saint-Marin
SRB = Serbie
SVK = Slovaquie
SVN = SlovÃ©nie
SWE = SuÃ¨de
VAT = Vatican / (Saint-SiÃ¨ge)
WCL = OcÃ©ans


Merci de partager.