Remember what I told You I have No fillers,so here u have the best Clubmusic right know.

31 Split tracks all songs are in 192/kbps and i hope you will like  it? ;)

I have more torrents out here klick on Tag,  Dj doc Phil 

O.B. S  No songs are 100% orginal if you need that dont DL here .


Aditya - Tracking Treasure Down(dj doc phil rmx edit)
Agnes - Sometimes i forget (dj doc phil remix edit) 
Alec Raw - Black rain [ben preston remix]
Alex C. - Listen to your heart (club mix edit) 
Alex Megane vs.Tonic - Try (dj doc phil rmix edit)
Beatbox ft. M. Slice - Why do you love (maxi club mix)
Coco - Babe You're a star  (extended original)
Dan Winter ft.Patricia - Every time (mdv radio edit)
Dee Dee - I want you back (club rockerz remix)
Desireless - Voyage  (benny benassi remix)
Dion Mavath - Refugee (original radio mix)
Dj doc Phil - The sample  (8.53 min)
Dj Fresh ft Leyla - Masterpiece (dj doc phil remix)
Dj Jose - Killer emotion (radio edit)
Goldfrapp - Rocket  (tiesto club remix)
Jennifer Lopez - Louboutins (dj doc phil short club remix)
Jessus Elsandrino - Style fusion (dj doc phil rmix)
Jim Foster - Every you every me (dj doc phil rmx edit)
Josh Gabriel ft.Kelly Winter - Deep down (dj doc phil r mix)
Junior Caldera ft.Sophie Ellis - Cant fight this feeling (club remix)
Justine Bieber - One Time  (dj doc phil r mx)
Ma Bra ft Rainy - Scream to the moon (dj doc phil rmx)
Mario Bischini - Special (play&win original mix)
Master Blaster - Until the end (dj doc phil remix)
Mia - Headlight (radio edit)
Neo - Human Frontier (dj doc phil r mix)
Silverscreen Vs. Londonbeat - Ive Been Thinking About You
System F - Cry (dj doc phil rmix edit)
Trilogy ft Angelstar - Last Night  (Bassmonkeys Extended Mix)
Vernessa Mitchell - Rise (dj doc phil extended club mix)
Zaar - Waiting (dj doc phil radio edit)


Enjoy and PlZ Seed..............I let this GREAT upload speaks for its self :)

You get more danceable music when i have.Brob next month or so..


Have it Dj Doc Phil  (play music is my work/way of living)


P.s alredy upload 13 Gig of this torrent D.s