This is a change in style and most definitely a one off hope you all enjoy Fidget house music because I really do at the min!! 


CD1

Evil Panda (Original Mix) - Sound Of Stereo	
Tear Down The Walls (A1 Bassline Remix) - Arthur Baker feat. Nona Hendrix & Ladonna	
Cracker Jack (Filthy Rehab Remix) - Royal K & Remy D	
Make My Music (Zodiac Cartel Remix) - Emanuel Kosh	
Hustler ( SPKR Ninjaz Remix) - Digital Freak	
Get Loose - Matt Cox	
Feel My Body (Eddie Queens Mix) - Nicola Fasano Vs. Frank` O Moiraghi	
Ghetto Ass Bitch (Original Mix) - Cold Blank	
Crank Up The Volume (Original Mix) - Young Nutz	
Freque - Down'n'Out	
Kiwi (Gtronic Just Another Bass Remix) - Mustard Pimp	
Breath (Filthy Rehab Remix) - The Prodigy	
Blaze The Ounce (Original Mix) - Danny Soundz feat Mr.Eyez	
Misfits (Aniki Remix) - Danny Soundz, Whiskey Pete,The Roach	
RUffnec Sound (Rude Boyz Rufefed Up Mix) - War Wobblins	
Dare (Original Mix) - Rico Tubbs	
Poppin s**t (Original Mix) - DJ Bam Bam	
Look At You (Original Mix) - Tim Healey & Atomic Hooligan	
Spoiled Rich Bitches (Pro 7 Remix) - Waxdolls	
South Park Shuffle (Mini K's Go Hard Or Go Home Mix) - Kid Tech	

CD2

Hey Baby (Kid Komas Remix) - Underproject	
Proper Bo (Original Mix) - Jason Williams	
The Dutty Drummer (Original Mix) - Will Bailey & Punk Rolla	
Shut Up (Royal K Remix) - Young Nutz	
Sexy Thing (Tom Wonder Jackin 2010 Remix) - DJ David	
Is This House - Down'n'Out	
Gangster (Original Mix) - Filthy Rehab	
Good Vibration (Jayforce Remix) - Frederik Mooij	
Bump (Original Mix) - Speaker	
Jackin The Disco B.E.A.T. (Dylan Holshausen Remix) - The Amp Jackers	
Real Bad (Original Mix) - DJ Antention	
Suck My Disko (Dylan Holshausen Disco In My Pants Mix) - Aniki	
Justin James (Chicago Remix) - Gay Marriage	
For You (Cybersutra Remix) - Hirshee	
Jailbait Rinse - Hot Mouth feat. Reid Speed	
Hopskipjack (Original Mix)	Kyle Watson	
Blast Off! - Lazy Rich & Hirshee feat. Lizzie Curious	
Jack N That Beanz Talk! (Jason Williams Remix) - The Amp Jackers	
One Day (Lazy Rich Remix) - L.B.One feat. Alice Edun	
Operator (Miles Dyson Remix) - DJ Dan & Uberzone feat. Blake Lewis