The Abyss (Avgrunden 1989)

500 meter under havsytan ligger en oljeborrstation. Den rekryteras i sÃ¶kandet 

efter en sjunken ubÃ¥t. Under arbetet med att sÃ¶ka den sjunkna ubÃ¥ten intrÃ¤ffar en 

olycka - och det visar sig att det finns nÃ¥got annat fÃ¶rdolt i havsdjupet...

Originaltitel

The Abyss

Land, Ã¥r, lÃ¤ngd
USA Ã¥r 1989, 140 min

RegissÃ¶r

James Cameron

Manus
James Cameron

SkÃ¥despelare
Ed Harris - Virgil 'Bud' Brigman
Mary Elizabeth Mastrantonio - Lindsey Brigman
Michael Biehn - Lt. Hiram Coffey
Leo Burmester - Catfish De Vries
Todd Graff - Alan 'Hippy' Carnes
John Bedford Lloyd - Jammer Willis
J.C. Quinn - Arliss 'Sonny' Dawson
Kimberly Scott - Lisa 'One Night' Standing
Captain Kidd Brewer Jr. - Lew Finler
George Robert Klek - Wilhite
Christopher Murphy - Schoenick, SEAL Team Member
Adam Nelson - Ensign Monk, SEAL Team Member
Dick Warlock - Dwight Perry
Jimmie Ray Weeks - Leland McBride
J. Kenneth Campbell - DeMarco
Ken Jenkins - Gerard Kirkhill
Chris Elliott - Bendix
Peter Ratray - USS Montana Captain
Michael Beach - Barnes
Brad Sullivan - USS Montana Executive Officer
Frank Lloyd - USS Montana Navigator
Phillip Darlington - USS Montana Crewman
Joseph C. Nemec III - USS Montana Crewman
Joe Farago - Anchorman
William Wisher Jr. - Bill Tyler, Reporter
Marcus K. Mukai - Anchorman
Wendy Gordon - Anchorwoman
Paula Cross - Young Woman
Thomas F. Duffy - Construction Worker
Chris Anastasio - Truck Driver
Emily Yancy - Woman Reporter
Michael Chapman - Dr. Berg
Tom Isbell - Wave Reporter

Inspelnings info
WS F Super 35

Produktions info

Mikael Salomon - FOTO

Joel Goodman - Klippning

Alan Silvestri - Musik

Gale Anne Hurd - Producent

Leslie Dilley - Scenografi

Laura Buff - Specialeffekter