Super MegaReMix dividido en varias partes de unos 30 minutos de duraciÃ³n realizadso por DJ SeeGeeB (AKA El Cazador De Canciones - The Songs Hunter)
La primera parte incluye estos 36 temas:

Mungo Jerry - In The Summertime
Imagination - Body Talk (12'' Version)
Bee Gees - You Win Again (12'' Extended Shep Pettibone 5'14 Mix)
UB40 - (I Can't Help) Falling In Love With You (Extended Mix)
Inner Circle - Sweat (A La La La La Long)
Joe Cocker - You Can Leave Your Hat On
Grace Jones - La Vie En Rose (12'' Version)
Sommerville - To Love Somebody (Boilerhouse Mix)
Falco - Rock Me Amadeus (Extended 12'' Mix)
UB40 - Red Red Wine

Andru Donalds - Mishale
Billy Joel - The River Of Dreams
Ace Of Base - All That She Wants
Akon - Lonely
Opus - Live Is Life
Art Company - Susanna (Long Version)
George Michael - Freedom '90 
Phil Collins - In The Air Tonight (Extended Version)
Tina Turner - What's Love Got To Do With It
Double - The Captain Of Her Heart

Peter Gabriel - Sledgehammer
Blondie - The Tide Is High
Maxi Priest - Close To You (Extended Version)
Toto - Africa (Extended Mix)
Debbie Harry - French Kissin
Milli Vanilli - Girl You Know It's True (Extended Version)
Spandau Ballet - True
P.M. Dawn - Set Adrift On Memory Bliss
Monyaka - Go Deh Yaka (12'' Version)
Gary Low - La Colegiala

Toto Feat. Cheryl Lynn - Georgy Porgy (Special Long Disco Version)
Tears For Fears - Shout (US Remix)
Nik Kershaw - Wouldnt It Be Good
George Michael - I Want Your Sex
Lionel Richie - Tender Heart
Alphaville - Big In Japan (Extended Version)