A must have pack for all party animals! This is an extension pack to my previous party collection, so if you like this one, make sure to check out the other one as well! You will find it here: 
 
http://thepiratebay.org/torrent/5369224/Party_music_-_collection_of_183_songs



Quality of the tracks varies between 192kbps - 320kbps


Here is a list of the songs:

Adam Lambert - Whataya Want From Me (fonzerelli_electro_house_radio_mix).mp3
Aisa & DJ Yaang - Without You (Original Mix).mp3
Akcent - Let's Talk About It.mp3
Akcent - On and on (Stay with me).mp3
Akcent And Eward Maya - That's My Name (lsd extended club).mp3
Akon Ft Colby ODonis And Kardinal Offishall - Beautiful.mp3
Alesha Dixon - Breathe Slow (Cahill Radio Edit).mp3
Alex Sayz f. Evi - Hate To Love.mp3
Alphabeat - Hole In My Heart (wideboys_stadium_radio_edit_remix).mp3
Backdraft - Hey Little Girl (subgroover extended mix).mp3
Benassi Bros Feat Sandy - Illusion.mp3
Blake Lewis - Heartbreak On Vinyl.mp3
BT - Suddenly (radiomix).mp3
Cascada - Fever.mp3
Chicane - Hiding All The Stars.mp3
Connect-R - Burning Love (Quentin Remix).mp3
Dakota - Heart And Soul (Jason Nevins Remix).mp3
Dance Nation Vs Shaun Baker - Sunshine 2009 (House Mix).mp3
Darin - Step up.mp3
Darude - Feel The Beat.mp3
Darude - I Ran (So Far Away).mp3
David Deejay feat. Ela Rose - I Can Feel.mp3
DJ Andi and Stella - Freedom.mp3
Dj Layla feat Alissa - Single Lady.mp3
Dj Project - Miracle Love.mp3
FloRida feat. David Guetta - Club Can Not Handle Me.mp3
Geo da silva - Ill do you like a truck.mp3
Geo Da Silva vs Dj Jungle - Far Away 2009 (Cj Stone remix).mp3
Hello Goodbye - Here (in your arms).mp3
Honorebel feat Pitbull And Jump Smokers - Now You See It.mp3
Hurts - Better Than Love.mp3
Iio - At the end.mp3
Inna - 10 minutes (Radio Edit by Play and Win).mp3
Iyaz - replay.mp3
Jason Derulo - In My Head.mp3
Jay Sean Ft Lil Wayne - Down (Jason Nevins Edit).mp3
Jus Jack With Phil Garrant feat. Matina Parisi - Smoke.mp3
Kelly Rowland Feat David Guetta - Commander.mp3
Kevax - Move Me Up (driver_und_face_remix).mp3
Kim Leoni - Again (original radio mix).mp3
Kim Sozzi - Feel Your Love.mp3
Little Boots - Remedy (wideboys stadium radio edit).mp3
Liviu Hodor & Tara - Happy For You.mp3
Livvi Franc - Automatik (smash_mode_radio).mp3
Madcon - Glow.mp3
Mark Sinclair - Pictures Of You.mp3
Pitbull - Pearly Gates.mp3
Play - Famous.mp3
Play & Win - Only.mp3
R.I.O. - Serenade (radio edit).mp3
Rihanna - Rude Boy.mp3
Selena Gomez & The Scene - Naturally.mp3
Spankers feat Barbara Clara - Tomamos En La Playa (sex on the beach).mp3
The Saturdays - Work.mp3
Timbaland - If We Ever Meet Again (featuring Katy Perry).mp3
Tinchy Strider Ft N Dubz - Number 1.mp3
Tom Boxer feat. Mike Diamondz - Dancing.mp3
Tripple Star - Insurrection (megara_vs._dj_lee_remix_edit).mp3
Usher Feat Will.I.Am - Omg.mp3
Usher feat. Lil' Jon & Ludacris - Yeah.mp3
Vibers feat.Tara McDonald - Revolution.mp3