 http://enigmat.webhop.net
.
Join My Facebook Page for latest updates  --
.
.
4mal Feat. Second Sky - The Game (Proton Grateful Remix) (Cut From Solarstone Set)-enTc.mp3
Adam Fielding - From Out Of Nowhere (Original Mix) (Set Rip)-enTc.mp3
Adam Nickey Pres. Blue8 - Eleventh Streets (Ferry Tayle & Static Blue Remix) (Set Rip)-enTc.mp3
Adrien Aubrun & Francois Dennig - Remembrance (Cut From Solarstone Set)-enTc.mp3
Afrojack - Radioman (Edx Remix) (Set Rip)-enTc.mp3
Alan Parson - Sirius (Brusca Remix) (Cut From Bonansea Set)-enTc.mp3
Albin Meyers & Sandro Monte Feat. Abigail Bailey - Somewhere (Dabruck & Klein Remix) (Set Rip)-enTc.mp3
Alex Pinar - Hamilton Post (David Anguix & Jacobo Martin Remix) (Cut From Flash Set)-enTc.mp3
Alucard - Elation (DJ Eco Remix) (ASOT 441 Rip)-enTc.mp3
Alucard - Elation (Original Mix) (GDJB Rip)-enTc.mp3
Ariel Ab - Beautiful Horizon (Original Mix) (Cut From Iborquiza Set)-enTc.mp3
Ariel Ab - Hidden Under The Sky (Original Mix) (Set Rip)-enTc.mp3
Ariel Ab - Illusion Summer (Fernando Ferreyra Remix) (Set Rip)-enTc.mp3
Ariel Ab - Nightime World (Original Mix) (Set Rip)-enTc.mp3
Ariel Curtis - Stolen (Santiago Deep Hard Remix) (Cut From Flash Set)-enTc.mp3
Ariel G & Chris Mackay - Superman Punch (Cut From Ariel G Set)-enTc.mp3
Armin Prayd - The Edge Of Lorankorou (Original Mix) (Cut From Shamanah Set)-enTc.mp3
Arnej vs. 8 Wonders - The Crossover (GDJB Rip)-enTc.mp3
Artego - Summer Bang (Swanky Tunes Remix) (Set Rip)-enTc.mp3
Autobooze - Tales Of Fracchi's Mansion (Cut From Frangellico Set)-enTc.mp3
Avatar One - Mercury & Solace (Adam Fielding Remix) (Set Rip)-enTc.mp3
B.o.n.g. - Meia Praia (Cut From Iborquiza Set)-enTc.mp3
Balcazar - Stuck On The Red Clue (Matt Rowan Remix) (Cut From Flash Set)-enTc.mp3
Beat Service Meets Tucandeo Featuring Manon Polare - Waiting for the Sun (-OvErSpAmMeD- Sample)-enTc.mp3
Belocca & Soneec - Rasperry Mouth (Cut From Ariel G Set)-enTc.mp3
Beltek feat. Justin Robertson - We Weren't Born To Die (Instrumental Mix) (Cut From Dobslaw Set) (Â«â€¢Â»)-enTc.mp3
Benny Maze - Lucid Dream (Cut From Jaytech Set)-enTc.mp3
Binary Finary - 1998 (tyDi & Dennis Sheperd Remix) (GDJB Rip)-enTc.mp3
Bobby Deep Feat. Venes - Get Me High (Volgelmann Remix) (Cut From Ariel AB Set)-enTc.mp3
Chris Soul & Richie Santana - 24 Bit Whore (Cut From Monnier Set)-enTc.mp3
Cid Inc. - Flopcorn (Rodskeez Remix) (Set Rip)-enTc.mp3
CJ Art - Credo (Cut From Frangellico Set)-enTc.mp3
Clinton Brown - Edge Of The Dancefloor (Reach Out Vocal Mix) (Cut From EDX Set)-enTc.mp3
Codec Shift - Cookie Session (Original Mix) (Cut From Shamanah Set)-enTc.mp3
Colle N Key - Feel The Music (Cut From Ty Tek Set)-enTc.mp3
D125 Balanced - Open Up (Jay Sustain Deep House Mix) (Cut From Audiokinetiks Set)-enTc.mp3
Dan Freeman - Balkan Promises (Intro Mix) (Set Rip)-enTc.mp3
Dan Freeman - Sasquatch Sex (Set Rip)-enTc.mp3
Daniel Portman - Back To The Underground (Set Rip)-enTc.mp3
Daniel Portman & Rion Cabrera - Sumatra (Version Night In The Club) (Set Rip)-enTc.mp3
Danny P - New Life (Mark Mendes Remix) (Cut From Ariel G Set)-enTc.mp3
Danny Routh - In My Memorium (Cut From Faskil Set)-enTc.mp3
Dave Seaman & Josh Gabriel - Heyaah (Original Mix) (Set Rip)-enTc.mp3
Dcm - 7 Days (Karrolxvii & Mb Valence Remix) (Cut From Phunktastike Set)-enTc.mp3
Deep Mariano - The Crystal Doll (Cut From CzD Set) (Â«â€¢Â»)-enTc.mp3
Depeche Mode - Wrong (Rauhover Mix) (Cut From Numf Set)-enTc.mp3
Derek Howell - Piano Key Neck Tie (Cut From Phunktastike Set)-enTc.mp3
Devoice - Splattery Mass (Francesco Pico Remix) (Cut From Numf Set)-enTc.mp3
Dfusion - Bank & Die (Original Mix) (Cut From Monnier Set)-enTc.mp3
D-Geetals - UNTITLED (Cut From Jacbri Set)-enTc.mp3
Dimau - Mamba (Cut From Frangellico Set)-enTc.mp3
Dinka & Lizzie Curiours - Green Leaf (Stanley Ross Mental Techno Remix) (Set Rip)-enTc.mp3
Disko Loco - Word Play (Cut From Flash Set)-enTc.mp3
DISTAFF - Clip out (Original Mix) (Cut From BS As Deep Set)-enTc.mp3
Distaff - Insane Mentally (Cut From Keekos Set)-enTc.mp3
DISTAFF - Insane Mentally (Original Mix) (Cut From BS As Deep Set)-enTc.mp3
DISTAFF & Nico Cano - Moskyto (Cut From BS As Deep Set) (Â«â€¢Â»)-enTc.mp3
Dj Ocinirom - Put And Unlock (Cut From BS As Deep Set)-enTc.mp3
Dj Tarkan & V-Sag - Bye (Chris Drifter Remix) (Cut From Bonansea Set)-enTc.mp3
Dole & Kom - Kids Final (Cut From Ariel G Set)-enTc.mp3
Dont - Who Is Dont (Cut From Kira Set)-enTc.mp3
Dont & Prins Mysjkin - Amalek (Cut From Kira Set)-enTc.mp3
Dp-6 - April (Cut From Zizou Set)-enTc.mp3
Dp-6 - Laguna (Cut From Zizou Set)-enTc.mp3
Eddie Amador - House Music (Marcelo Vasami Remix) (Cut From Femmes Set)-enTc.mp3
Edwin & Ferdy - A Day In The Park (Cut From Jaytech Set)-enTc.mp3
EDX - Party of Politics (Original Club Mix) (Cut From Dobslaw Set) (Â«â€¢Â»)-enTc.mp3
Edx - Shy Shy (Club Mix) (Set Rip)-enTc.mp3
Enmass - So Please (Alexander Popov Remix) (ASOT 441 Rip)-enTc.mp3
Estiva - Friends & Enemies (ASOT 441 Rip)-enTc.mp3
Evren Ulusoy - Freelove (Rodskeez Remix) (Set Rip)-enTc.mp3
Exoplanet - Metaphor (Cut From Epoch Set)-enTc.mp3
F&F - Action Reaction (Ferreyra Edit) (Cut From Frangellico Set)-enTc.mp3
False Ikon - Just A Few Words (Cut From Xaric Set)-enTc.mp3
False Ikon - Miss Arholl (Cut From Xaric Set)-enTc.mp3
Federico Epis - Bahrein (Nomad In The Dark vs. Vagabond Remix) (Cut From Keekos Set)-enTc.mp3
Federico Milani - Cyloom (Cut From BS As Deep Set) (Â«â€¢Â»)-enTc.mp3
Federico Monachesi - Black Dust (Cut From Boscarino Set)-enTc.mp3
Felix Stone - Revolucion (Derek Howell Remix) (Set Rip)-enTc.mp3
FKN Featuring Laurie - Alone (Aurosonic Remix) (GDJB Rip)-enTc.mp3
Francesco Pico - Like The Old Days (-Short- Cut From Jaap Set)-enTc.mp3
Frangellico - My Last Letter (Set Rip)-enTc.mp3
Frangellico - Playing God (Break Mix) (Set Rip)-enTc.mp3
Frangellico - To Baltazar (Set Rip)-enTc.mp3
Freza & Sergeque - Experiance (Cain Archer Remix) (Cut From Monnier Set)-enTc.mp3
G Thomas - Glisten (Fake Remix) (Cut From Ty Tek Set)-enTc.mp3
Gerardo Borscarino & Monachesi - Was About Time (Federico Giust Remix) (Set Rip)-enTc.mp3
Glenn Morrison - Another Suggestion (Cut From Andi C Set)-enTc.mp3
Grunjah - Systematic Nonsense (Phunk Investigation Remix) (Cut From Giust Set)-enTc.mp3
Gui Sheffer - Time Of Life (Michael & Levan and Stiven Rivic Remix) (Cut From Milli Set)-enTc.mp3
Guy J - Lamur (Henry Saiz Remix 2) (Set Rip)-enTc.mp3
Hawkshaw & Holden - Fine Day (Jaap Ligthart Remix) (Set Rip)-enTc.mp3
Holosound - Free You (Nosmo Vs. Kris B Remix) (Cut From Rodskeez Set)-enTc.mp3
Hooja - Rising Star (ASOT 441 Rip)-enTc.mp3
Ignacio Demaria & Steve Prior - Friday (-OvErSpAmMeD- Cut From Solarstone Set) (Â«â€¢Â»)-enTc.mp3
Jaap Lighart - Turn Around (Cut From Kira Set)-enTc.mp3
Jaap Ligthart - Alive Cat (Set Rip)-enTc.mp3
Jaap Ligthart & Dr Dev AKA The Outrageous Okona's - Achintya (Set Rip)-enTc.mp3
Jairus Miller - Lurker (Cut From Howell Set)-enTc.mp3
Jake Benson Feat. K-Lee - I'm Alone (Original Mix) (Cut From Milli Set)-enTc.mp3
Jaybeetrax - Arrived (Original Mix) (Cut From Ariel AB Set)-enTc.mp3
Jca - I'll See Her Again (Jerome Isma-Ae Remix) (Cut From Flash Set)-enTc.mp3
Jeff Daniels - My Soul (Oliver Joel Remix) (Cut From Flash Set)-enTc.mp3
Jeffrey Collins - Control (Conrad Rogers Vocal Remix) (Cut From BS As Deep Set)-enTc.mp3
Jeremiah - Synergy (Cut From Xaric Set)-enTc.mp3
John Askew - Bad Bad Apple (Alan Ruddick's Rotten Edit) (Cut From Equalibrium Set)-enTc.mp3
Jona Prado - Two Things (Jona Prado Remix) (Cut From Bonansea Set)-enTc.mp3
Joris Voorn - Chase The Mouse (Stephan Bodzin Rejected 8 Remix) (Cut From Tiger Stripes Set)-enTc.mp3
Josh Gabriel - Entropy (Original Mix) (Set Rip)-enTc.mp3
Josh Lasden Synoptic - Wednesday Morning (Cut From Zizou Set)-enTc.mp3
Jozef Kugler - Last Station (Original Mix) (Cut From FeralCode Set)-enTc.mp3
Julien Loreto - Good Old Days (Cut From Howell Set)-enTc.mp3
Kasey Voorn - Out On A Lamb (Lank Remix) (Cut From Xaric Set)-enTc.mp3
Kassey Voorn - Life On Hold (Original Mix) (Cut From Femmes Set)-enTc.mp3
Kris Wadsworth - Mainline (Sei A Remix) (Cut From Luzz Set)-enTc.mp3
Luca Ricci & Ventinesimo Secolo - Tribute To San Francesco (Ariel Ab Remix) (Set Rip)-enTc.mp3
Luciano Lima & Juan Pablo Sachetti - Deepress Hill (Cut From Monnier Set)-enTc.mp3
Luetzenkirchen - Tomm (Cut From Numf Set)-enTc.mp3
M Larrosa & G. Sava - Distress (Cut From Frangellico Set)-enTc.mp3
Mango - Forever July (Chris Nemmo Remix) (Cut From Epoch Set)-enTc.mp3
Marco Dassi - Polarize (Cut From BS As Deep Set)-enTc.mp3
Marcos Paz & Gabuci - Negative (Martin Bonansea Remix) (Set Rip)-enTc.mp3
Mariano Martinez -AKA- Phunktastike - Deep Think (Set Rip)-enTc.mp3
Mario Ayuda - UNTITLED (Cut From Equalibrium Set) (Â«â€¢Â»)-enTc.mp3
Mark Voxx Feat. Mc Grace - Submissions (Deepfresh & Emanuel Remix) (Cut From Flash Set)-enTc.mp3
Mary Mercury - Plastic Baby (Enge[i]ne Mediative Mix) (Cut From Xaric Set)-enTc.mp3
Mary Mercury & Enge[i]ne - 17 Breath (Cut From Xaric Set)-enTc.mp3
Masque - Le Reves De Vous (Cut From Jacbri Set)-enTc.mp3
Masque - Poetry (Cut From Mooney Set)-enTc.mp3
Mastercrisis - Follow Me (Silinder Remix) (Cut From Monnier Set)-enTc.mp3
Max Demand - Poseidon (Distant Fragment Remix) (Set Rip)-enTc.mp3
Maxi Iborquiza - Kanzi (Original Mix) (Set Rip)-enTc.mp3
Maxi Iborquiza - Regen (Original Mix) (Set Rip)-enTc.mp3
MCQ - Flamboyant (Siasia Remix) (Cut From Howell Set)-enTc.mp3
Michael Costa - Malate (Cut From Howell Set)-enTc.mp3
Mickey Nightrain - Ignatius II (Cut From Monnier Set)-enTc.mp3
Mikel Curcio - Thinking Out Loud (Cesar Bass Romero Remix) (Cut From Femmes Set)-enTc.mp3
Moony - I'll Be Lovin You Forever (Deminicis Mix) (Cut From Frangellico Set)-enTc.mp3
Mossy - Dalimo (Cut From Ty Tek Set)-enTc.mp3
Naiad - No Sobriety (Cut From Ariel G Set)-enTc.mp3
NDKj & GGDex - Dubai (Marcello Concialdi Remix) (Cut From Howell Set)-enTc.mp3
Nemus & Little Nakoch - Fellas From Favelas (Original Mix)  (Cut From Lima Set)-enTc.mp3
Nemus & Little Nakoch - Green Lady (Nicholas Van Orton Remix) (Cut From Audiokinetiks Set)-enTc.mp3
Niaz Arca - Outside Venus (Cut From Solarstone Set)-enTc.mp3
Nicolas Sparvieri - Kalashnikov (Alejo Gonzalez Remix) (Cut From Ariel AB Set)-enTc.mp3
Nicolas Sparvieri - The B House (Original Mix) (Cut From Ariel AB Set)-enTc.mp3
Pacco & Rudy B - Magnetic Fields (Dub) (Cut From Jacbri Set)-enTc.mp3
Paul Harris & Obernik - The Take (Edx's Acapulco At Night Remix) (Set Rip)-enTc.mp3
Paul Hind - UNTITLED (Cut From Equalibrium Set) (Â«â€¢Â»)-enTc.mp3
Penner Muder - Are You Lost (Sian Remix) (Cut From Guy J Set)-enTc.mp3
Phunk Investigation vs. Paul Ursin & Benny Benew - Tutan (PI Reworked The Mix) (Cut From Schossow Set)-enTc.mp3
Pleasure Sound - Elvi (Original Mix) (Cut From Ariel AB Set)-enTc.mp3
Python Feat. Cream Sound - MoonWalking (Overcast Remix) (Cut From Milli Set)-enTc.mp3
Quarrel - Sonic Boom (Dcm Remix) (Cut From Phunktastike Set)-enTc.mp3
Rennie Foster - Roughshod (Angel Alanis Remix) (Cut From Luzz Set)-enTc.mp3
Rodskeez Feat. Diego Ramos - My Challenge (Original Mix) (Set Rip)-enTc.mp3
Ron van den Beuken - Her Tears Namira (Liam Goodwin Epic Remix) (Cut From Schossow Set) (Â«â€¢Â»)-enTc.mp3
Royal Sapien - Everybody (Indicant Remix) (Cut From Mooney Set)-enTc.mp3
Ruslan Sever - Yangun Tau (Original Mix) (Cut From Solarstone Set) (Â«â€¢Â»)-enTc.mp3
Saints & Sinners - Pushin Too Hard (Guy J Remix) (Cut From Keekos Set)-enTc.mp3
Sander Kleinenberg - This Is Our Night (Original Mix) (Cut From Gabriel Set)-enTc.mp3
Sander Van Doorn - Roundabout (Josh Gabriel Bootleg) (Set Rip)-enTc.mp3
Sasha - Magnetic North (Lank Airboottroger 2010 Remix) (Cut From Xaric Set)-enTc.mp3
Saul B - Objects In The Mirror Are Closed Than They Appears (Original Mix) (Cut From Lima Set)-enTc.mp3
Science Deal - Loonybeam Theme (Original Mix) (Cut From Cesar Set)-enTc.mp3
Scope - 6.15 In The Morning (Cut From Luzz Set)-enTc.mp3
Sebastian Garuti - Irlanda (Cut From Boscarino Set)-enTc.mp3
Sender - Tuner (Hard Rock Sofa Remix) (Cut From Swanky Set)-enTc.mp3
Sentrise Pres. Solid Sunrise - Venus (Rene Alblaze Remix) (Cut From Numf Set)-enTc.mp3
Shamanah - Close Your Eyes (Original Mix) (Set Rip)-enTc.mp3
Shamanah - Kontack (Original Mix) (Set Rip)-enTc.mp3
Shiloh - Landmine Hopscotch (Original Mix) (Cut From Epoch Set)-enTc.mp3
Sin Tek - Hypocrisie (Cut From Phunktastike Set)-enTc.mp3
Skytech - Comet (The Space Rockerz Remix) (GDJB Rip)-enTc.mp3
Solano - Making Waves (Cut From Schossow Set) (Â«â€¢Â»)-enTc.mp3
Something Good - 128am (Cut From Jaytech Set)-enTc.mp3
South Boy, Dj Giorgio & Syp - Process (Original Mix) (Cut From Boscarino Set)-enTc.mp3
Stereo K - Kif The Rif (Cut From Xaric Set)-enTc.mp3
Steve Brian - La Gomera (Cressida Remix) (ASOT 441 Rip)-enTc.mp3
Suburb Kubatko - Feng Shui (Cut From Jacbri Set)-enTc.mp3
Supernova - Escta Loca (Bonus Tech Beat Mix) (Cut From Lumen Set)-enTc.mp3
Syke & Sugarstarr Feat. Alexandra Prince - Are You Watching Me (Ivan Spell Remix) (Cut From Flash Set)-enTc.mp3
Synchronized - Breach (Original Mix) (Cut From Rodskeez Set)-enTc.mp3
System F - Out of the Blue (Simon Gain Remix) (GDJB Rip)-enTc.mp3
T Orlando - Versus (Cut From D-Phrag Set)-enTc.mp3
Taho - Hypnotize (Cut From CzD Set)-enTc.mp3
The F Project - Rise (Saul B Remix) (Cut From Vogelmann Set)-enTc.mp3
The Planters Feat. MartÃ­n Lima - We Forgot Bobby (Original Mix) (Cut From Lima Set)-enTc.mp3
The Remedy - Shot In The Dark (Cut From Epoch Set)-enTc.mp3
Thorne Monterra & Ersa - (Jaap Ligthart Remix) (Set Rip)-enTc.mp3
Tiger Stripes - Make It House (Set Rip)-enTc.mp3
Tim Andresen - Closer (Cut From Distant Frag Set)-enTc.mp3
Tim Andresen - Do You Thang (Chris Mimo Remix) (Cut From Portman Set) (Â«â€¢Â»)-enTc.mp3
Tim Andresen - Far Away (Cut From Distant Frag Set)-enTc.mp3
Tim Jingerson - Keep It Simple (Original Mix) (Cut From Audiokinetiks Set)-enTc.mp3
Tom Neville & Stafford Brothers - Come My Way (Mark Simmons Remix) (Cut From Equalibrium Set)-enTc.mp3
Tom Pritchard - Reset (Cut From Solarstone Set)-enTc.mp3
Trebland - Microgap (Matthew Nagle Remix) (Cut From Schossow Set) (Â«â€¢Â»)-enTc.mp3
Trenix Presents Adamuna - Cherry Blossom (Avatar One Remix) (Set Rip) (Â«â€¢Â»)-enTc.mp3
Trim The Fat - Urban Tiger (Justin Steel Remix) (Cut From Kira Set)-enTc.mp3
Tunneltube - Creamfiller (Cut From Mooney Set)-enTc.mp3
Ugo Lucchese - Loose Control (Cut From Monnier Set)-enTc.mp3
UNKNOWN - Mars (Style Of Eye Remix) (Cut From Tiger Stripes Set)-enTc.mp3
Utku Dalmaz - Statiscope (Cut From BS As Deep Set)-enTc.mp3
Viktor Fox - Incu (Cut From Zizou Set)-enTc.mp3
Vincent Vega - Le Cocaine (Dj Renat Remix) (Cut From Flash Set)-enTc.mp3
Virtual Vault Feat. Orjan - Too Late (ASOT 441 Rip)-enTc.mp3
Vojt Van Twistigen Pres Encorton - Nightwalk (Cut From Solarstone Set)-enTc.mp3
Vooz Brothers - Moneymaker (Conrad Rogers Remix) (Cut From Audiokinetiks Set)-enTc.mp3
Wilenski Roman - Jasmine (Cut From Epoch Set)-enTc.mp3
Yuuki - Drugstar (Cut From Xaric Set)-enTc.mp3
Yuuki Hori - Chain (Cut From Xaric Set)-enTc.mp3
Zicky - San Pedro (Andrea Bertolini Remix) (Cut From Lima Set)-enTc.mp3
