 http://enigmat.webhop.net
.
Join My Facebook Page for latest updates  --
.
.
7he Myriads - Ocean (Summer Love) (Cut From Cockatoos Set)-enTc.mp3
Abstract Vision & Elite Electronic - Time (Cut From MIKE Set)-enTc.mp3
Afternova - Serenity (Andy Blueman Remix) (ASOT 447 Rip)-enTc.mp3
Afternova - Serenity (Original Mix) (Cut From MIKE Set)-enTc.mp3
Alfoa - Peyote (Deep House Mix) (Cut From Cryo Set)-enTc.mp3
Alfoa - Shinning (Original Mix) (Cut From Cryo Set)-enTc.mp3
Antix & Embark - Lost & Found (Cut From Unique Set)-enTc.mp3
Arno E Mathieu - Horse Tears (Markus Enochson Remix) (Cut From Digweed Set)-enTc.mp3
Aurosonic - Always Together (Original Mix) (ASOT 447 Rip)-enTc.mp3
Christian Smith - Beluga (Secret Cinema Remix) (Cut From Unique Set)-enTc.mp3
Chuck Lepley - Six Days (Cut From Digweed Set)-enTc.mp3
Chuck Lepley Feat Cajardo Un - 6 Days (Original Mix) (Cut From Bee Set)-enTc.mp3
D-Mad - UNTITLED (Cut From Chiu Set) -!-.mp3
Dynamic Emotion - Welcome to My Head (Progressiver Remix) (Cut From Angel Ace Set)-enTc.mp3
Egbert - Geizer (Cut From Unique Set)-enTc.mp3
Felix Da Housecat - Silverscreen (Mandy Remix) (Cut From Digweed Set) -!-.mp3
Fine Taste & Kid Broke - Lifebloom (Cut From Graham Set)-enTc.mp3
First State - Cape Point (Blake Jarrell Remix) (ASOT 447 Rip)-enTc.mp3
Golden Bug - Flamingo (Pete Herbert Remix) (Cut From Cockatoos Set)-enTc.mp3
Hybrid - Break My Soul (Intro Loop) (Cut From Jaytech Set)-enTc.mp3
Hybrid - Break My Soul (UNKNOWN Remix) (Cut From J00F Set)-enTc.mp3
Hypnotic Duo - Memory Lights (Cut From Southward Set)-enTc.mp3
Ivan Nikusev & Wav-E - One Day Before (Guido Percich Remix) (Cut From Southward Set)-enTc.mp3
Johnny Yono - Victoria (Cut From Chiu Set) -!-.mp3
Jona - Rise (Cut From Digweed Set)-enTc.mp3
Juventa - Dreamer's Diary (Science Deal Remix) (Cut From Jerom Set)-enTc.mp3
Kahraman - Memat (Seba Rebolero Remix) (Cut From CzD Set) -!-.mp3
King Unique - Feniksas (Fergie Remix) (Cut From Unique Set)-enTc.mp3
Klartraum - Phantomkatzen (Original Mix) (Cut From Bee Set)-enTc.mp3
K-milian - Oditi (Salt Sweet Remix) (Cut From Stoynoff Set)-enTc.mp3
Livin R & Sean Angel Feat. Giorgio Sopidi - It's Over Now (Cut From CzD Set)-enTc.mp3
Luiz B - Song Of Life (Soundstrom Remix) (Cut From Stoynoff Set)-enTc.mp3
Markus Schulz Featuring Khaz - Dark Heart Waiting (Club Mix) (GDJB Rip)-enTc.mp3
Martin Landsky - Monitir One (Cut From Digweed Set) -!-.mp3
Massive Attack - Attack Psyche (Android Cartel Remix) (Cut From Digweed Set)-enTc.mp3
Matt Darey Pres. Urban Astronauts - Black Flowers (Josh Gabriel Remix) (ASOT 447 Rip)-enTc.mp3
Matt Lange - East Coast (Ad Brown Remix) (Cut From Jaytech Set) -!-.mp3
Michael & Levan and Stiven Rivic - Angel Dream (Kintar Remix) (Cut From J00F Set)-enTc.mp3
Mike Shiver Vs. Matias Lehtola - Snooze (Samuel Jackson Remix) (Cut From Chiu Set)-enTc.mp3
Moonbeam Featuring Daniel Mimra - Look Around (Moon Stage Remix) (GDJB Rip)-enTc.mp3
Mr. Pit - This Room is Not Big Enough (Tech Mix) (GDJB Rip)-enTc.mp3
Nima Gorji - Watching Out (Cut From Digweed Set)-enTc.mp3
Pacco & Ruby B - Lemuria (Fady Ferraye Remix) (Cut From Bee Set)-enTc.mp3
Paul Keeley - Flyby (Cut From Jaytech Set) -!-.mp3
Paul Mad, Memo Insua & Daniel Larusso - Pink Neon (Original Mix) (Cut From Cryo Set)-enTc.mp3
Pete Heller - Tune In Drop Out (Cut From Digweed Set) -!-.mp3
Peter Horrevorts - Bloody Hands (Marc Marzenit Monster Remix) (-Sample- Cut From Unique Set)-enTc.mp3
Phaxe - The Gateway (Cut From J00F Set)-enTc.mp3
Rex Mundi - Opera of Northern Ocean (Phynn Remix) (GDJB Rip)-enTc.mp3
Ripperton - Random Violence (Joris Voorn Remix) (Cut From Digweed Set)-enTc.mp3
RPO - UNTITLED -March 2010- (Cut From J00F Set)-enTc.mp3
Schodt - Kyushu (B.O.N.G. Remix) (Cut From Chiu Set) -!-.mp3
Seph Vier - Cocktail (Original Mix) (Cut From Bee Set)-enTc.mp3
Simon Firth - Strawberries (Trim The Fat Remix) (Cut From Jaytech Set)-enTc.mp3
TasteXperience - Summersault (Airwave Remix) (GDJB Rip)-enTc.mp3
Tim Grube - Amador (Skytech Remix) (ASOT 447 Rip)-enTc.mp3
Triangle Feat. Mark Ridout - Five We've Found It (Cut From Unique Set)-enTc.mp3
W&W vs. Jonas Stenberg - Alligator Fuckhouse (Bjorn Akesson Remix) (ASOT 447 Rip)-enTc.mp3