This is a mix made by tommysaib using virtualdj software.
Most of  places were mixed well, but few got worst. Anyway I give this in raw, without normalizing sounds. 
Hope u 'll enjoy. 

*Songs list*
Bhool Bhoolaiyaa - Bhool Bhoolaiyaa
Bluffmaster - Tadbeer Se Bigdi Hui Taqdeer
Aladin - Genie Rap
CHOCOLATE - halka halka sa yeh
Dil Bole Hadippa - Bhangra Bistar
Singh Is Kinng - Singh Is Kinng
Race - Khwab Dekhe
Love Aaj Kal - Twist
Kambakkht Ishq - Om Mangalam
Jai Veeru - Agre Ka Ghagra
Jab We Met - Mauja Hi Mauja
Krazzy 4 - Krazzy 4
Dil Bole Hadippa - Gym Shim
Apne - Ankh Vich Chehra Pyaar Da
Chak De India - Chak De India
fanna - Des Rangila
DUS - dus bahane ker ke
Jhoom Barabar Jhoom - Kiss Of Love
Jodhaa Akbar - Azeem-O-Shaan Shahenshah
MAIN HOON NA - tumse milke dilka hai
NEAL AND NIKKI - halla re
One 2 Ka 4 - 1_2_ka_4
Road side Romio - Cool Cool
Short Kut - Patli Galli
Tashan - Dil Dance Maare
Wanted - Love Me Love Me
One Two Three - Gup Chup
Love Aaj Kal - Chori Bazari
Kismat Konnection - Move Your Body Now

Thanx SONGS_dot_PK for original songs

***"If u like this, Seed after download"***