 http://enigmat.webhop.net
.
Become a Fan of My Facebook Page --  by clicking LIKE
.
Access The EnigmaTDC Hub For Direct Downloads   
http://enigmat.webstarts.com/
.
4 Strings Featuring Ellie Lawson - Safe from Harm (Extended Mix) (Cut From SvD Set)-enTc.mp3
Abstract Vision - Hurricane (Ivica Vanevski & Saturn 6 Remix) (Cut From Jerom Set)-enTc.mp3
Accadia - Blind Visions (Neptune Project Third Eye Mix) (Cut From Kearney Set)-enTc.mp3
Ad Brown - Memorial (Maor Levi Club Mix) (Cut From Levi Set)-enTc.mp3
Adam Shornys & Dezza - Chapters (Cut From Pledger Set)-enTc.mp3
Air Night - Remember (Original Mix) (Cut From Saux Set)-enTc.mp3
Air Night - Remember (Suprano Remix) (Cut From ReOrder Set) (Â«â€¢Â»)-enTc.mp3
Airbase - We Might Fall (Cut From Jong Set)-enTc.mp3
Aleksey Yakovlev - Gentle Sun (Slavix Epic Mix) (Cut From ReOrder Set) (Â«â€¢Â»)-enTc.mp3
Amex vs Francesco Sambero - Sunlight Therapy (Cut From Durand Set)-enTc.mp3
Andres Cabrera - Lumino (Niklas Gustavsson Remix) (Cut From Flash Bro Set)-enTc.mp3
Anthony Waldhorn - Serenity (Original Mix) (Cut From Shah Set)-enTc.mp3
Aquaspace - Miles from Nowhere (Cut From Allyn Set)-enTc.mp3
Aquaspace - Wide Open (Cut From Allyn Set)-enTc.mp3
Arcane Science - One More Day (Corderoy Remix) (Cut From Suzy Set)-enTc.mp3
Audiotec - Japanacia (Cut From Allyn Set)-enTc.mp3
Bjork - Hyperballad (Nick Galea 2010 Remix) (TATW 339 Rip)-enTc.mp3
Blugazer - Singer Island (Peter Lesko Remix) (Cut From Del Mar Set)-enTc.mp3
Bryan Kearney - Mexican Rave (Neal Scarborough Remix) (-Short- Set Rip)-enTc.mp3
BT - Flaming June (Stereojackers Remake) (Cut From Luke Terry Set)-enTc.mp3
Bushi - Flurry (Original Mix) (Cut From Gibson Set)-enTc.mp3
Claudia Cazacu - Timelapse (Cut From Jules Set)-enTc.mp3
Craving - Aquatica (Cut From First State Set)-enTc.mp3
Craving - First Feeling (Cut From First State Set)-enTc.mp3
Crimson - Sky (Craving Remix) (Cut From Anderson Set)-enTc.mp3
Dajan - Preoccupied In Thoughts (Adam Ariess Remix) (Cut From Del Mar Set)-enTc.mp3
Dan Meyer - Autuman Grean Leaves (Cut From Flash Bro Set)-enTc.mp3
Dark Matter Feat. Missing Jem - Sweet Dreams (Fabio Steins Dying Vaio Remix) (-Short- Cut From Feel Set)-enTc.mp3
Deeplife - Arazu (Cut From Flash Bro Set)-enTc.mp3
Deeplife - The Green Zone (DJ Synchro Remix) (Cut From Flash Bro Set)-enTc.mp3
Der Mystik - Exotisk (Cut From Nadz Set)-enTc.mp3
Digital Horizon - Hold The Motion (Vitodito Remix) (Cut From First State Set)-enTc.mp3
DJ Jose - Hesitate (Mac Zimms Remix) (Cut From Arnesto Set)-enTc.mp3
DJ Maxsie & Alex Speaker - Pull On (Cut From Tyas Set)-enTc.mp3
Dual Senses - Dual Senses (Cut From Pledger Set)-enTc.mp3
Duality - Just Add Water (Plathysma Remix) (Set Rip)-enTc.mp3
Duck Sauce Duck Sauce - Barbra Streisand (Afrojack Meat Mix) (Cut From Jules Set)-enTc.mp3
Easton - Time Lapse (Jpl Remix) (Cut From Del Mar Set)-enTc.mp3
Element One - Everyone On Earth (Cut From Schossow Set)-enTc.mp3
Enyo - Magnesium (Original Mix) (Cut From Feel Set)-enTc.mp3
Espen Lorentzen - Delia (Original Mix) (Cut From ReOrder Set) (Â«â€¢Â»)-enTc.mp3
Estiva - Adamas (Cut From First State Set)-enTc.mp3
Fabian Jakopetz - Victoria (Jan Peters Dark Italo Remix) (Cut From Flash Bro Set)-enTc.mp3
Faruk Sabanci - Himalaya (Daniel Kandi's Rise Mix) (Cut From Faruk Set) (Â«â€¢Â»)-enTc.mp3
First State Feat. Relyk - Cross The Line (George Acosta Remix) (Set Rip)-enTc.mp3
Gordon Coutts - Different Angles (Cut From Coutts Set)-enTc.mp3
Gregorio Styreco - The Forgotten (ReOrder Deep Mix) (Cut From ReOrder Set) (Â«â€¢Â»)-enTc.mp3
Henandez - Vera (Cut From Jules Set)-enTc.mp3
Hiroyuki ODA - Light Velocity (Cut From Space Garden Set)-enTc.mp3
Hurts - Wonderful Life (Lee Haslam Remix) (Cut From Haslam Set)-enTc.mp3
Ian Solano - In Real Time (Original Mix) (Cut From SvD Set)-enTc.mp3
Icone - Sintra (Nicholas Bennison Remix) (Cut From Allyn Set)-enTc.mp3
Jay Ronko & Josh Newson - Icarus (Ronn Sono & Thice Santoros Closer To The Sun Remix) (Cut From Flash Bro Set)-enTc.mp3
Joel Gershom - Radiate (Ankhen Remix) (Cut From Shah Set)-enTc.mp3
John Askew - Intimate Strangers (-Short- Cut From Askew Set)-enTc.mp3
Julie Thompson - Shine (JPL & George Hales Remix) (Cut From O'Neil Set)-enTc.mp3
Karanda - Curveball (Set Rip)-enTc.mp3
Katsarov - Chokeslam (Vintage Mix) (Cut From Katsarov Set)-enTc.mp3
Katy Perry - Teenage Dream (Digital Self Mix) (Cut From Del Mar Set)-enTc.mp3
Kenan Teke - Love Switch (Cut From Shadows Set) (Â«â€¢Â»)-enTc.mp3
Konstantine - Together (Hydrogenio Remix) (Cut From Feel Set) (Â«â€¢Â»)-enTc.mp3
Lay & Browne - Spiratus (Cut From Pledger Set)-enTc.mp3
Leon Bolier vs. W&W - Saturn (Daniel Wanrooy Remix) (Cut From Feel Set)-enTc.mp3
Live Synthetica - 20 Miles (Original Mix) (Cut From Suzy Set)-enTc.mp3
Lost Connection - Dangerous Game (Original Mix) (Cut From Shah Set)-enTc.mp3
Luke Terry - For All I Dream Of (Cut From Luke Terry Set)-enTc.mp3
Maarten de Jong - A50 (MDJ Mix) (Cut From Sherry Set)-enTc.mp3
Magnetic Man feat. Katy B - Perfect Stranger (Steve Angello Remix) (Cut From SvD Set)-enTc.mp3
Mango - Here We Go (Cut From Durand Set) (Â«â€¢Â»)-enTc.mp3
Marc Lenner - Sunny Clouds (Luca De Maas Remix) (Cut From Rashkov Set)-enTc.mp3
Matt Hardwick - My Mind (-Short- Cut From Jules Set)-enTc.mp3
Medina - You and I (Woody van Eyden 2011 Remix) (-Sample-)-enTc.mp3
Michal Poliak - Ambulance (Dark Mix) (Cut From Pledger Set)-enTc.mp3
Milana - Feel Real (Flash Brothers Remix) (Set Rip)-enTc.mp3
Mindflow - Switched (Cutline Remix) (Cut From PvD Set)-enTc.mp3
MoodFreak - Restrained Emotion (TATW 339 Rip) (Â«â€¢Â»)-enTc.mp3
Mystic Blue - Coastline (Original Mix) (Cut From Suzy Set)-enTc.mp3
Nalin & Kane - Beachball 2010 (Marco Lys Remix) (Cut From Levi Set)-enTc.mp3
Naturlaits - Illectroniquete (Cut From Flash Bro Set)-enTc.mp3
Newton - 4 Seasons (Original Mix) (Cut From Saint-Jules Set)-enTc.mp3
Nigel Christie - Spectral (Cut From Tyas Set) (Â«â€¢Â»)-enTc.mp3
Nightshift - Sunset Lullaby (Ryan Mendoza's San Francisco Mix) (Cut From Luke Terry Set)-enTc.mp3
Norland - Wasabi (Function C Remix) (Cut From Space Garden Set)-enTc.mp3
Oceanic - Aryan (Original Mix) (Cut From Shah Set)-enTc.mp3
Olbaid & Alpha Force - I'll Go With You (Cut From Shadows Set)-enTc.mp3
Paul Gibson - Fusion (Cut From Gibson Set)-enTc.mp3
Pe & Ban - Trauma (-Short- Cut From Claessen Set)-enTc.mp3
Philips & Meijer - Infinite Impulse (Cut From Sied Set)-enTc.mp3
Pierre Pienaar - Life.Love.Lies (Original Mix) (Cut From EvB Set)-enTc.mp3
Rave Channel - All I Need (All I Have) (Broning Remix) (Cut From Feel Set)-enTc.mp3
Rebecca Saforia - Paradigm Shift (Indecent Noise Remix) (Cut From Coutts Set)-enTc.mp3
Red Carpet - Level Two (Original Mix) (Cut From Bennett Set)-enTc.mp3
ReOrder - Angels (Original Mix) (Cut From ReOrder Set)-enTc.mp3
Roger Antux - Try (Jonathan Sc Remix) (Cut From Space Garden Set)-enTc.mp3
Roger Shah Pres. Sunlounger - Acapulco Waves (Original Mix) (Cut From Shah Set) (Â«â€¢Â»)-enTc.mp3
Sean Tyas pres. Syat Naes - Unnamed (Cut From Tyas Set) (Â«â€¢Â»)-enTc.mp3
SHato - Pure Reflected (Sean Bayer's Progressive Mix) (Cut From ReOrder Set) (Â«â€¢Â»)-enTc.mp3
Sherry, Allan & Wild - Cold Sweat (Original Mix) (Cut From EvB Set)-enTc.mp3
Simon Gain & Kris O'Neil - Endless Love (Cut From O'Neil Set)-enTc.mp3
Skyloops - Unsencored (Cut From Allyn Set)-enTc.mp3
Snow Patrol - Just Say Yes (Liquid Vision Remix) (Cut From Faruk Set)-enTc.mp3
Solex - Victim Of Love (Grube Vs Hovsepian Remix) (Cut From Del Mar Set)-enTc.mp3
Something Good - Solence (UU Island Refunk Mix) (Cut From Flash Bro Set)-enTc.mp3
Space RockerZ - When In Rome (Bastian Salbart Vision) (Cut From Pledger Set)-enTc.mp3
Stunson - Perfect Bliss (Cut From Pledger Set)-enTc.mp3
Suncatcher - First Day (Ferry Tayle Remix) (Cut From Saux Set)-enTc.mp3
Suncatcher - UNTITLED (Cut From Faruk Set)-enTc.mp3
Sunset - The Blue Sky (Matt Skyer Remix) (Cut From Saux Set)-enTc.mp3
Swedish House Mafia - Miami 2 Ibiza (Sander van Doorn Remix) (Cut From SvD Set)-enTc.mp3
Tamerlan & Djons - Northern Lights (Cut From Space Garden Set)-enTc.mp3
Tempo Giusto - Apocalypse (Original Mix) (Cut From Tempo Set)-enTc.mp3
Tempo Giusto - For That Someone (Original Mix) (Cut From Tempo Set)-enTc.mp3
Tempo Giusto - Matheo (Original Mix) (Cut From Tempo Set)-enTc.mp3
Tempo Giusto - UNTITLED (Original Mix) (Cut From Tempo Set)-enTc.mp3
The Prime Sins - enHouse 2009 Anthem (Tiddey Remix) (Cut From Thuggar Set)-enTc.mp3
The Shrink - Nervous Breakdown 2010 (Timothy Allan Remix) (Cut From Coutts Set)-enTc.mp3
Thomas Coastline - Ultralite (Trance Mix) (Set Rip)-enTc.mp3
Three N One pres Johnny Shaker - Pearl River (Alex MORPH Remix) (Cut From Feel Set)-enTc.mp3
TN & Albert van Leizer Feat. Joshua - Everytime (Joe Shadows Dub Mix) (Set Rip)-enTc.mp3
Total Sound - Endless Love (Matt Bukovski Remix) (Cut From A&F Set)-enTc.mp3
Tyler Michaud & Interstate - Junkie (Heatbeat Remix) (-Short- Cut From Bolier Set)-enTc.mp3
Tyler Michaud Feat. Colleen Kelly - Get You Higher (Define Crazy Mix) (Cut From Anderson Set)-enTc.mp3
Tyler Michaud Feat. Colleen Kelly - Get You Higher (Thomas Penton vs. Stripwalker Remix) (Cut From Feel Set)-enTc.mp3
UCast - Endeavor (Original Mix) (Cut From Suzy Set)-enTc.mp3
UNKNOWN - UNTITLED (ReOrder Remix) (Cut From ReOrder Set)-enTc.mp3
UNKNOWN - UNTITLED 001 (Distant Identity Remix) (Set Rip)-enTc.mp3
UNKNOWN - UNTITLED 002 (Distant Identity Remix) (Set Rip) (Â«â€¢Â»)-enTc.mp3
V.I.F. - My Own Side (Cut From O'Neil Set)-enTc.mp3
