Description..

Here is part 4 of this collection thus far
Again hope i provided some favourites for ya

have a nice day!


Please SEED for others to Enjoy!
Cheers, Bubanee

SONG LIST..

Always Something There To Remind Me - Naked Eyes.mp3 	
And She Was - Talking Heads.mp3 	
Believe It Or Not - Joey Scarbury.mp3 	
Blame It On The Boogie - The Jacksons.mp3 		
Cars - Gary Numan.mp3 	
Crying In The Chapel - Peter Blakeley.mp3 	
Down Under - Men At Work.mp3 	
Drop the Pilot - Joan Armatrading.mp3 	
Fade To Grey - Visage.mp3 	
Glad I'm Not a Kennedy - Shona Laing.mp3 	
Harden My Heart - Quarterflash.mp3 		
He's So Shy - The Pointer Sisters.mp3 	
I Didn't Mean to Be Mean - Mental as Anything.mp3 	
I Got You - Split Enz.mp3 		
I Love A Rainy Night - Eddie Rabbitt.mp3 		
I'll Be Loving You (Forever) - New Kids On The Block.mp3 	
Jessies Girl - Rick Springfield.mp3 	
Keep On Loving You - REO Speedwagon.mp3 	
Keep Ya Hands To Ya Self - Georgia Satellites.mp3 	
Key Largo - Bertie Higgins.mp3 
Let My Love Open The Door - Pete Townshend.mp3 	
Let's Go - The Cars.mp3 	
Love My Way - Psychedelic Furs.mp3 		
Love Plus One - Haircut 100 .mp3 		
Medley - The Beach Boys.mp3 	
Missing You - John Waite.mp3 		
Our House - Madness.mp3 	
Perfect - Fairground Attraction.mp3 	
Puttin' On The Ritz - Taco.mp3 	
Radio - The Members.mp3 		
Rain - Dragon.mp3 	
Relax - Frankie Goes to Hollywood.mp3 		
Shake It Up - The Cars.mp3 		
She Blinded Me With Science - Thomas Dolby.mp3 
Slow Hand - The Pointer Sisters.mp3 		
Super Freak (Part 1) - Rick James.mp3 
Take Me Back - Noiseworks.mp3 		
The Look Of Love - ABC.mp3 		
Too Shy - Kajagoogoo.mp3 		
Up Where We Belong - Joe Cocker and Jennifer Warne.mp3 
Walk This Way - Run DMC ft. Aerosmith.mp3 		
What About Me - Moving Pictures.mp3 		
What Is Love - Howard Jones.mp3 	
What's Love Got To Do With It - Tina Turner.mp3 		
Where Did I Go Wrong - UB40.mp3 		
Who Can It Be Now - Men At Work.mp3 		
Wild Wild Life - Talking Heads.mp3 		
Winners - Moving Pictures.mp3 	
Wishing Well - Terance Trent D'Arby.mp3 	
You Got It - Roy Orbison.mp3 	


INFORMATION..

...........Name/Year - 1980s The Ultimate Collection Of Hits Pt.4

.......Bubanee CDRip - Yes
.........Other CDRip - 
.....Covers/CD JPegs - 
Log/Cue/M3U Playlist - 
...CD Rip Created By - 
....Internet Release - 
..........MP3 Format - VBR V0
MP3 Average Bit Rate - 257Kbps
...........MP3 Codec - (Lame) Earlier CDRips 3.98r Later Ones 3.99a
.........FLAC Format - 
......Other Versions - 
.........Alterations -
........Video Format -
.........Video Audio -
...........Container -
............NTSC/PAL -
................Menu -
..........Auto Start - 

I Just Do.. Enjoy The Ride.. Bubaneeâ„¢